,date,away,away_pts,home,home_pts,pt_diff,home_win,home_loss
0,2019-10-22,New Orleans Pelicans,122,Toronto Raptors,130,8,1,0
1,2019-10-22,Los Angeles Lakers,102,Los Angeles Clippers,112,10,1,0
2,2019-10-23,Chicago Bulls,125,Charlotte Hornets,126,1,1,0
3,2019-10-23,Detroit Pistons,119,Indiana Pacers,110,-9,0,1
4,2019-10-23,Cleveland Cavaliers,85,Orlando Magic,94,9,1,0
5,2019-10-23,Minnesota Timberwolves,127,Brooklyn Nets,126,-1,0,1
6,2019-10-23,Memphis Grizzlies,101,Miami Heat,120,19,1,0
7,2019-10-23,Boston Celtics,93,Philadelphia 76ers,107,14,1,0
8,2019-10-23,Washington Wizards,100,Dallas Mavericks,108,8,1,0
9,2019-10-23,New York Knicks,111,San Antonio Spurs,120,9,1,0
10,2019-10-23,Oklahoma City Thunder,95,Utah Jazz,100,5,1,0
11,2019-10-23,Sacramento Kings,95,Phoenix Suns,124,29,1,0
12,2019-10-23,Denver Nuggets,108,Portland Trail Blazers,100,-8,0,1
13,2019-10-24,Atlanta Hawks,117,Detroit Pistons,100,-17,0,1
14,2019-10-24,Milwaukee Bucks,117,Houston Rockets,111,-6,0,1
15,2019-10-24,Los Angeles Clippers,141,Golden State Warriors,122,-19,0,1
16,2019-10-25,Toronto Raptors,106,Boston Celtics,112,6,1,0
17,2019-10-25,Minnesota Timberwolves,121,Charlotte Hornets,99,-22,0,1
18,2019-10-25,New York Knicks,109,Brooklyn Nets,113,4,1,0
19,2019-10-25,Chicago Bulls,110,Memphis Grizzlies,102,-8,0,1
20,2019-10-25,Dallas Mavericks,123,New Orleans Pelicans,116,-7,0,1
21,2019-10-25,Washington Wizards,97,Oklahoma City Thunder,85,-12,0,1
22,2019-10-25,Phoenix Suns,107,Denver Nuggets,108,1,1,0
23,2019-10-25,Portland Trail Blazers,122,Sacramento Kings,112,-10,0,1
24,2019-10-25,Utah Jazz,86,Los Angeles Lakers,95,9,1,0
25,2019-10-26,Miami Heat,131,Milwaukee Bucks,126,-5,0,1
26,2019-10-26,Philadelphia 76ers,117,Detroit Pistons,111,-6,0,1
27,2019-10-26,Orlando Magic,99,Atlanta Hawks,103,4,1,0
28,2019-10-26,Boston Celtics,118,New York Knicks,95,-23,0,1
29,2019-10-26,Toronto Raptors,108,Chicago Bulls,84,-24,0,1
30,2019-10-26,Indiana Pacers,99,Cleveland Cavaliers,110,11,1,0
31,2019-10-26,New Orleans Pelicans,123,Houston Rockets,126,3,1,0
32,2019-10-26,Washington Wizards,122,San Antonio Spurs,124,2,1,0
33,2019-10-26,Sacramento Kings,81,Utah Jazz,113,32,1,0
34,2019-10-26,Los Angeles Clippers,122,Phoenix Suns,130,8,1,0
35,2019-10-27,Golden State Warriors,92,Oklahoma City Thunder,120,28,1,0
36,2019-10-27,Brooklyn Nets,133,Memphis Grizzlies,134,1,1,0
37,2019-10-27,Portland Trail Blazers,121,Dallas Mavericks,119,-2,0,1
38,2019-10-27,Miami Heat,109,Minnesota Timberwolves,116,7,1,0
39,2019-10-27,Charlotte Hornets,101,Los Angeles Lakers,120,19,1,0
40,2019-10-28,Chicago Bulls,98,New York Knicks,105,7,1,0
41,2019-10-28,Indiana Pacers,94,Detroit Pistons,96,2,1,0
42,2019-10-28,Orlando Magic,95,Toronto Raptors,104,9,1,0
43,2019-10-28,Philadelphia 76ers,105,Atlanta Hawks,103,-2,0,1
44,2019-10-28,Oklahoma City Thunder,112,Houston Rockets,116,4,1,0
45,2019-10-28,Cleveland Cavaliers,112,Milwaukee Bucks,129,17,1,0
46,2019-10-28,Golden State Warriors,134,New Orleans Pelicans,123,-11,0,1
47,2019-10-28,Portland Trail Blazers,110,San Antonio Spurs,113,3,1,0
48,2019-10-28,Utah Jazz,96,Phoenix Suns,95,-1,0,1
49,2019-10-28,Denver Nuggets,101,Sacramento Kings,94,-7,0,1
50,2019-10-28,Charlotte Hornets,96,Los Angeles Clippers,111,15,1,0
51,2019-10-29,Atlanta Hawks,97,Miami Heat,112,15,1,0
52,2019-10-29,Dallas Mavericks,109,Denver Nuggets,106,-3,0,1
53,2019-10-29,Memphis Grizzlies,91,Los Angeles Lakers,120,29,1,0
54,2019-10-30,Chicago Bulls,111,Cleveland Cavaliers,117,6,1,0
55,2019-10-30,New York Knicks,83,Orlando Magic,95,12,1,0
56,2019-10-30,Minnesota Timberwolves,95,Philadelphia 76ers,117,22,1,0
57,2019-10-30,Milwaukee Bucks,105,Boston Celtics,116,11,1,0
58,2019-10-30,Indiana Pacers,118,Brooklyn Nets,108,-10,0,1
59,2019-10-30,Detroit Pistons,113,Toronto Raptors,125,12,1,0
60,2019-10-30,Portland Trail Blazers,102,Oklahoma City Thunder,99,-3,0,1
61,2019-10-30,Houston Rockets,159,Washington Wizards,158,-1,0,1
62,2019-10-30,Charlotte Hornets,118,Sacramento Kings,111,-7,0,1
63,2019-10-30,Los Angeles Clippers,96,Utah Jazz,110,14,1,0
64,2019-10-30,Phoenix Suns,121,Golden State Warriors,110,-11,0,1
65,2019-10-31,Miami Heat,106,Atlanta Hawks,97,-9,0,1
66,2019-10-31,Denver Nuggets,107,New Orleans Pelicans,122,15,1,0
67,2019-10-31,San Antonio Spurs,97,Los Angeles Clippers,103,6,1,0
68,2019-11-01,Houston Rockets,116,Brooklyn Nets,123,7,1,0
69,2019-11-01,Cleveland Cavaliers,95,Indiana Pacers,102,7,1,0
70,2019-11-01,Milwaukee Bucks,123,Orlando Magic,91,-32,0,1
71,2019-11-01,New York Knicks,102,Boston Celtics,104,2,1,0
72,2019-11-01,Detroit Pistons,106,Chicago Bulls,112,6,1,0
73,2019-11-01,Los Angeles Lakers,119,Dallas Mavericks,110,-9,0,1
74,2019-11-01,Utah Jazz,101,Sacramento Kings,102,1,1,0
75,2019-11-01,San Antonio Spurs,127,Golden State Warriors,110,-17,0,1
76,2019-11-02,New Orleans Pelicans,104,Oklahoma City Thunder,115,11,1,0
77,2019-11-02,Brooklyn Nets,109,Detroit Pistons,113,4,1,0
78,2019-11-02,Denver Nuggets,91,Orlando Magic,87,-4,0,1
79,2019-11-02,Phoenix Suns,114,Memphis Grizzlies,105,-9,0,1
80,2019-11-02,Toronto Raptors,105,Milwaukee Bucks,115,10,1,0
81,2019-11-02,Minnesota Timberwolves,131,Washington Wizards,109,-22,0,1
82,2019-11-02,Charlotte Hornets,93,Golden State Warriors,87,-6,0,1
83,2019-11-02,Philadelphia 76ers,129,Portland Trail Blazers,128,-1,0,1
84,2019-11-03,Chicago Bulls,95,Indiana Pacers,108,13,1,0
85,2019-11-03,Houston Rockets,100,Miami Heat,129,29,1,0
86,2019-11-03,Sacramento Kings,113,New York Knicks,92,-21,0,1
87,2019-11-03,Los Angeles Lakers,103,San Antonio Spurs,96,-7,0,1
88,2019-11-03,Dallas Mavericks,131,Cleveland Cavaliers,111,-20,0,1
89,2019-11-03,Utah Jazz,94,Los Angeles Clippers,105,11,1,0
90,2019-11-04,Detroit Pistons,99,Washington Wizards,115,16,1,0
91,2019-11-04,New Orleans Pelicans,125,Brooklyn Nets,135,10,1,0
92,2019-11-04,Houston Rockets,107,Memphis Grizzlies,100,-7,0,1
93,2019-11-04,Milwaukee Bucks,134,Minnesota Timberwolves,106,-28,0,1
94,2019-11-04,Philadelphia 76ers,109,Phoenix Suns,114,5,1,0
95,2019-11-04,Portland Trail Blazers,118,Golden State Warriors,127,9,1,0
96,2019-11-05,Indiana Pacers,120,Charlotte Hornets,122,2,1,0
97,2019-11-05,Boston Celtics,119,Cleveland Cavaliers,113,-6,0,1
98,2019-11-05,San Antonio Spurs,100,Atlanta Hawks,108,8,1,0
99,2019-11-05,Los Angeles Lakers,118,Chicago Bulls,112,-6,0,1
100,2019-11-05,Orlando Magic,94,Oklahoma City Thunder,102,8,1,0
101,2019-11-05,Miami Heat,89,Denver Nuggets,109,20,1,0
102,2019-11-06,New York Knicks,102,Detroit Pistons,122,20,1,0
103,2019-11-06,Washington Wizards,106,Indiana Pacers,121,15,1,0
104,2019-11-06,Chicago Bulls,113,Atlanta Hawks,93,-20,0,1
105,2019-11-06,Golden State Warriors,112,Houston Rockets,129,17,1,0
106,2019-11-06,Sacramento Kings,120,Toronto Raptors,124,4,1,0
107,2019-11-06,Minnesota Timberwolves,121,Memphis Grizzlies,137,16,1,0
108,2019-11-06,Orlando Magic,106,Dallas Mavericks,107,1,1,0
109,2019-11-06,Philadelphia 76ers,104,Utah Jazz,106,2,1,0
110,2019-11-06,Milwaukee Bucks,129,Los Angeles Clippers,124,-5,0,1
111,2019-11-07,Boston Celtics,108,Charlotte Hornets,87,-21,0,1
112,2019-11-07,Oklahoma City Thunder,112,San Antonio Spurs,121,9,1,0
113,2019-11-07,Miami Heat,124,Phoenix Suns,108,-16,0,1
114,2019-11-07,Portland Trail Blazers,101,Los Angeles Clippers,107,6,1,0
115,2019-11-08,Detroit Pistons,106,Indiana Pacers,112,6,1,0
116,2019-11-08,Memphis Grizzlies,86,Orlando Magic,118,32,1,0
117,2019-11-08,Cleveland Cavaliers,113,Washington Wizards,100,-13,0,1
118,2019-11-08,Sacramento Kings,121,Atlanta Hawks,109,-12,0,1
119,2019-11-08,Golden State Warriors,119,Minnesota Timberwolves,125,6,1,0
120,2019-11-08,Toronto Raptors,122,New Orleans Pelicans,104,-18,0,1
121,2019-11-08,New York Knicks,106,Dallas Mavericks,102,-4,0,1
122,2019-11-08,Philadelphia 76ers,97,Denver Nuggets,100,3,1,0
123,2019-11-08,Milwaukee Bucks,100,Utah Jazz,103,3,1,0
124,2019-11-08,Brooklyn Nets,119,Portland Trail Blazers,115,-4,0,1
125,2019-11-08,Miami Heat,80,Los Angeles Lakers,95,15,1,0
126,2019-11-09,Boston Celtics,135,San Antonio Spurs,115,-20,0,1
127,2019-11-09,New Orleans Pelicans,115,Charlotte Hornets,110,-5,0,1
128,2019-11-09,Houston Rockets,117,Chicago Bulls,94,-23,0,1
129,2019-11-09,Dallas Mavericks,138,Memphis Grizzlies,122,-16,0,1
130,2019-11-09,Golden State Warriors,108,Oklahoma City Thunder,114,6,1,0
131,2019-11-10,Denver Nuggets,100,Minnesota Timberwolves,98,-2,0,1
132,2019-11-10,Indiana Pacers,109,Orlando Magic,102,-7,0,1
133,2019-11-10,Charlotte Hornets,106,Philadelphia 76ers,114,8,1,0
134,2019-11-10,Milwaukee Bucks,121,Oklahoma City Thunder,119,-2,0,1
135,2019-11-10,Cleveland Cavaliers,108,New York Knicks,87,-21,0,1
136,2019-11-10,Brooklyn Nets,112,Phoenix Suns,138,26,1,0
137,2019-11-10,Atlanta Hawks,113,Portland Trail Blazers,124,11,1,0
138,2019-11-10,Toronto Raptors,113,Los Angeles Lakers,104,-9,0,1
139,2019-11-11,Minnesota Timberwolves,120,Detroit Pistons,114,-6,0,1
140,2019-11-11,Dallas Mavericks,106,Boston Celtics,116,10,1,0
141,2019-11-11,Memphis Grizzlies,113,San Antonio Spurs,109,-4,0,1
142,2019-11-11,Houston Rockets,122,New Orleans Pelicans,116,-6,0,1
143,2019-11-11,Utah Jazz,122,Golden State Warriors,108,-14,0,1
144,2019-11-11,Toronto Raptors,88,Los Angeles Clippers,98,10,1,0
145,2019-11-12,Oklahoma City Thunder,85,Indiana Pacers,111,26,1,0
146,2019-11-12,Cleveland Cavaliers,97,Philadelphia 76ers,98,1,1,0
147,2019-11-12,Detroit Pistons,108,Miami Heat,117,9,1,0
148,2019-11-12,New York Knicks,102,Chicago Bulls,120,18,1,0
149,2019-11-12,Atlanta Hawks,125,Denver Nuggets,121,-4,0,1
150,2019-11-12,Los Angeles Lakers,123,Phoenix Suns,115,-8,0,1
151,2019-11-12,Brooklyn Nets,114,Utah Jazz,119,5,1,0
152,2019-11-12,Portland Trail Blazers,99,Sacramento Kings,107,8,1,0
153,2019-11-13,Memphis Grizzlies,119,Charlotte Hornets,117,-2,0,1
154,2019-11-13,Philadelphia 76ers,97,Orlando Magic,112,15,1,0
155,2019-11-13,Washington Wizards,133,Boston Celtics,140,7,1,0
156,2019-11-13,Los Angeles Clippers,93,Houston Rockets,102,9,1,0
157,2019-11-13,San Antonio Spurs,114,Minnesota Timberwolves,129,15,1,0
158,2019-11-13,Golden State Warriors,94,Los Angeles Lakers,120,26,1,0
159,2019-11-13,Toronto Raptors,114,Portland Trail Blazers,106,-8,0,1
160,2019-11-14,Miami Heat,108,Cleveland Cavaliers,97,-11,0,1
161,2019-11-14,Chicago Bulls,115,Milwaukee Bucks,124,9,1,0
162,2019-11-14,Los Angeles Clippers,127,New Orleans Pelicans,132,5,1,0
163,2019-11-14,Dallas Mavericks,103,New York Knicks,106,3,1,0
164,2019-11-14,Atlanta Hawks,112,Phoenix Suns,128,16,1,0
165,2019-11-14,Brooklyn Nets,93,Denver Nuggets,101,8,1,0
166,2019-11-15,Detroit Pistons,106,Charlotte Hornets,109,3,1,0
167,2019-11-15,San Antonio Spurs,109,Orlando Magic,111,2,1,0
168,2019-11-15,Indiana Pacers,102,Houston Rockets,111,9,1,0
169,2019-11-15,Utah Jazz,106,Memphis Grizzlies,107,1,1,0
170,2019-11-15,Washington Wizards,137,Minnesota Timberwolves,116,-21,0,1
171,2019-11-15,Philadelphia 76ers,119,Oklahoma City Thunder,127,8,1,0
172,2019-11-15,Boston Celtics,105,Golden State Warriors,100,-5,0,1
173,2019-11-15,Sacramento Kings,97,Los Angeles Lakers,99,2,1,0
174,2019-11-16,Brooklyn Nets,117,Chicago Bulls,111,-6,0,1
175,2019-11-16,Milwaukee Bucks,102,Indiana Pacers,83,-19,0,1
176,2019-11-16,Charlotte Hornets,103,New York Knicks,102,-1,0,1
177,2019-11-16,New Orleans Pelicans,94,Miami Heat,109,15,1,0
178,2019-11-16,Houston Rockets,125,Minnesota Timberwolves,105,-20,0,1
179,2019-11-16,Toronto Raptors,102,Dallas Mavericks,110,8,1,0
180,2019-11-16,Portland Trail Blazers,121,San Antonio Spurs,116,-5,0,1
181,2019-11-16,Atlanta Hawks,101,Los Angeles Clippers,150,49,1,0
182,2019-11-17,Philadelphia 76ers,114,Cleveland Cavaliers,95,-19,0,1
183,2019-11-17,Boston Celtics,99,Sacramento Kings,100,1,1,0
184,2019-11-17,Denver Nuggets,131,Memphis Grizzlies,114,-17,0,1
185,2019-11-17,Washington Wizards,121,Orlando Magic,125,4,1,0
186,2019-11-17,Golden State Warriors,100,New Orleans Pelicans,108,8,1,0
187,2019-11-17,Atlanta Hawks,101,Los Angeles Lakers,122,21,1,0
188,2019-11-18,Cleveland Cavaliers,105,New York Knicks,123,18,1,0
189,2019-11-18,Indiana Pacers,115,Brooklyn Nets,86,-29,0,1
190,2019-11-18,Charlotte Hornets,96,Toronto Raptors,132,36,1,0
191,2019-11-18,Milwaukee Bucks,115,Chicago Bulls,101,-14,0,1
192,2019-11-18,Portland Trail Blazers,108,Houston Rockets,132,24,1,0
193,2019-11-18,San Antonio Spurs,110,Dallas Mavericks,117,7,1,0
194,2019-11-18,Boston Celtics,99,Phoenix Suns,85,-14,0,1
195,2019-11-18,Minnesota Timberwolves,112,Utah Jazz,102,-10,0,1
196,2019-11-18,Oklahoma City Thunder,88,Los Angeles Clippers,90,2,1,0
197,2019-11-19,Golden State Warriors,114,Memphis Grizzlies,95,-19,0,1
198,2019-11-19,Portland Trail Blazers,104,New Orleans Pelicans,115,11,1,0
199,2019-11-19,Phoenix Suns,116,Sacramento Kings,120,4,1,0
200,2019-11-19,Oklahoma City Thunder,107,Los Angeles Lakers,112,5,1,0
201,2019-11-20,New York Knicks,104,Philadelphia 76ers,109,5,1,0
202,2019-11-20,San Antonio Spurs,132,Washington Wizards,138,6,1,0
203,2019-11-20,Milwaukee Bucks,135,Atlanta Hawks,127,-8,0,1
204,2019-11-20,Charlotte Hornets,91,Brooklyn Nets,101,10,1,0
205,2019-11-20,Golden State Warriors,94,Dallas Mavericks,142,48,1,0
206,2019-11-20,Cleveland Cavaliers,100,Miami Heat,124,24,1,0
207,2019-11-20,Orlando Magic,97,Toronto Raptors,113,16,1,0
208,2019-11-20,Detroit Pistons,89,Chicago Bulls,109,20,1,0
209,2019-11-20,Utah Jazz,103,Minnesota Timberwolves,95,-8,0,1
210,2019-11-20,Houston Rockets,95,Denver Nuggets,105,10,1,0
211,2019-11-20,Boston Celtics,104,Los Angeles Clippers,107,3,1,0
212,2019-11-21,Portland Trail Blazers,129,Milwaukee Bucks,137,8,1,0
213,2019-11-21,New Orleans Pelicans,124,Phoenix Suns,121,-3,0,1
214,2019-11-22,Atlanta Hawks,103,Detroit Pistons,128,25,1,0
215,2019-11-22,Charlotte Hornets,118,Washington Wizards,125,7,1,0
216,2019-11-22,Sacramento Kings,97,Brooklyn Nets,116,19,1,0
217,2019-11-22,Miami Heat,116,Chicago Bulls,108,-8,0,1
218,2019-11-22,Los Angeles Lakers,130,Oklahoma City Thunder,127,-3,0,1
219,2019-11-22,San Antonio Spurs,104,Philadelphia 76ers,115,11,1,0
220,2019-11-22,Cleveland Cavaliers,101,Dallas Mavericks,143,42,1,0
221,2019-11-22,Boston Celtics,92,Denver Nuggets,96,4,1,0
222,2019-11-22,Golden State Warriors,109,Utah Jazz,113,4,1,0
223,2019-11-22,Houston Rockets,119,Los Angeles Clippers,122,3,1,0
224,2019-11-23,Phoenix Suns,100,Minnesota Timberwolves,98,-2,0,1
225,2019-11-23,Chicago Bulls,116,Charlotte Hornets,115,-1,0,1
226,2019-11-23,Orlando Magic,106,Indiana Pacers,111,5,1,0
227,2019-11-23,Toronto Raptors,119,Atlanta Hawks,116,-3,0,1
228,2019-11-23,San Antonio Spurs,111,New York Knicks,104,-7,0,1
229,2019-11-23,Miami Heat,86,Philadelphia 76ers,113,27,1,0
230,2019-11-23,Portland Trail Blazers,104,Cleveland Cavaliers,110,6,1,0
231,2019-11-23,Los Angeles Lakers,109,Memphis Grizzlies,108,-1,0,1
232,2019-11-23,Detroit Pistons,90,Milwaukee Bucks,104,14,1,0
233,2019-11-23,New Orleans Pelicans,120,Utah Jazz,128,8,1,0
234,2019-11-24,Dallas Mavericks,137,Houston Rockets,123,-14,0,1
235,2019-11-24,Brooklyn Nets,103,New York Knicks,101,-2,0,1
236,2019-11-24,Sacramento Kings,113,Washington Wizards,106,-7,0,1
237,2019-11-24,Phoenix Suns,104,Denver Nuggets,116,12,1,0
238,2019-11-24,New Orleans Pelicans,109,Los Angeles Clippers,134,25,1,0
239,2019-11-25,Brooklyn Nets,108,Cleveland Cavaliers,106,-2,0,1
240,2019-11-25,Orlando Magic,88,Detroit Pistons,103,15,1,0
241,2019-11-25,Memphis Grizzlies,114,Indiana Pacers,126,12,1,0
242,2019-11-25,Minnesota Timberwolves,125,Atlanta Hawks,113,-12,0,1
243,2019-11-25,Sacramento Kings,102,Boston Celtics,103,1,1,0
244,2019-11-25,Charlotte Hornets,100,Miami Heat,117,17,1,0
245,2019-11-25,Philadelphia 76ers,96,Toronto Raptors,101,5,1,0
246,2019-11-25,Portland Trail Blazers,117,Chicago Bulls,94,-23,0,1
247,2019-11-25,Utah Jazz,118,Milwaukee Bucks,122,4,1,0
248,2019-11-25,Los Angeles Lakers,114,San Antonio Spurs,104,-10,0,1
249,2019-11-25,Oklahoma City Thunder,100,Golden State Warriors,97,-3,0,1
250,2019-11-26,Los Angeles Clippers,114,Dallas Mavericks,99,-15,0,1
251,2019-11-26,Washington Wizards,104,Denver Nuggets,117,13,1,0
252,2019-11-27,Brooklyn Nets,110,Boston Celtics,121,11,1,0
253,2019-11-27,Detroit Pistons,101,Charlotte Hornets,102,1,1,0
254,2019-11-27,Orlando Magic,116,Cleveland Cavaliers,104,-12,0,1
255,2019-11-27,Utah Jazz,102,Indiana Pacers,121,19,1,0
256,2019-11-27,Sacramento Kings,91,Philadelphia 76ers,97,6,1,0
257,2019-11-27,New York Knicks,98,Toronto Raptors,126,28,1,0
258,2019-11-27,Miami Heat,108,Houston Rockets,117,9,1,0
259,2019-11-27,Los Angeles Clippers,121,Memphis Grizzlies,119,-2,0,1
260,2019-11-27,Atlanta Hawks,102,Milwaukee Bucks,111,9,1,0
261,2019-11-27,Minnesota Timberwolves,113,San Antonio Spurs,101,-12,0,1
262,2019-11-27,Washington Wizards,140,Phoenix Suns,132,-8,0,1
263,2019-11-27,Los Angeles Lakers,114,New Orleans Pelicans,110,-4,0,1
264,2019-11-27,Oklahoma City Thunder,119,Portland Trail Blazers,136,17,1,0
265,2019-11-27,Chicago Bulls,90,Golden State Warriors,104,14,1,0
266,2019-11-29,Boston Celtics,107,Brooklyn Nets,112,5,1,0
267,2019-11-29,Charlotte Hornets,110,Detroit Pistons,107,-3,0,1
268,2019-11-29,Toronto Raptors,90,Orlando Magic,83,-7,0,1
269,2019-11-29,Milwaukee Bucks,119,Cleveland Cavaliers,110,-9,0,1
270,2019-11-29,Philadelphia 76ers,101,New York Knicks,95,-6,0,1
271,2019-11-29,Atlanta Hawks,104,Indiana Pacers,105,1,1,0
272,2019-11-29,Utah Jazz,103,Memphis Grizzlies,94,-9,0,1
273,2019-11-29,Golden State Warriors,105,Miami Heat,122,17,1,0
274,2019-11-29,New Orleans Pelicans,104,Oklahoma City Thunder,109,5,1,0
275,2019-11-29,Los Angeles Clippers,97,San Antonio Spurs,107,10,1,0
276,2019-11-29,Dallas Mavericks,120,Phoenix Suns,113,-7,0,1
277,2019-11-29,Chicago Bulls,103,Portland Trail Blazers,107,4,1,0
278,2019-11-29,Washington Wizards,103,Los Angeles Lakers,125,22,1,0
279,2019-11-30,Denver Nuggets,97,Sacramento Kings,100,3,1,0
280,2019-11-30,Indiana Pacers,116,Philadelphia 76ers,119,3,1,0
281,2019-11-30,Atlanta Hawks,111,Houston Rockets,158,47,1,0
282,2019-11-30,Charlotte Hornets,96,Milwaukee Bucks,137,41,1,0
283,2019-12-01,Miami Heat,109,Brooklyn Nets,106,-3,0,1
284,2019-12-01,Memphis Grizzlies,115,Minnesota Timberwolves,107,-8,0,1
285,2019-12-01,Boston Celtics,113,New York Knicks,104,-9,0,1
286,2019-12-01,Dallas Mavericks,114,Los Angeles Lakers,100,-14,0,1
287,2019-12-01,San Antonio Spurs,98,Detroit Pistons,132,34,1,0
288,2019-12-01,Oklahoma City Thunder,107,New Orleans Pelicans,104,-3,0,1
289,2019-12-01,Golden State Warriors,96,Orlando Magic,100,4,1,0
290,2019-12-01,Utah Jazz,110,Toronto Raptors,130,20,1,0
291,2019-12-01,Washington Wizards,125,Los Angeles Clippers,150,25,1,0
292,2019-12-02,Phoenix Suns,109,Charlotte Hornets,104,-5,0,1
293,2019-12-02,Utah Jazz,94,Philadelphia 76ers,103,9,1,0
294,2019-12-02,Golden State Warriors,79,Atlanta Hawks,104,25,1,0
295,2019-12-02,Indiana Pacers,117,Memphis Grizzlies,104,-13,0,1
296,2019-12-02,New York Knicks,88,Milwaukee Bucks,132,44,1,0
297,2019-12-02,Chicago Bulls,113,Sacramento Kings,106,-7,0,1
298,2019-12-03,Detroit Pistons,127,Cleveland Cavaliers,94,-33,0,1
299,2019-12-03,Orlando Magic,127,Washington Wizards,120,-7,0,1
300,2019-12-03,Dallas Mavericks,118,New Orleans Pelicans,97,-21,0,1
301,2019-12-03,Miami Heat,121,Toronto Raptors,110,-11,0,1
302,2019-12-03,Houston Rockets,133,San Antonio Spurs,135,2,1,0
303,2019-12-03,Los Angeles Lakers,105,Denver Nuggets,96,-9,0,1
304,2019-12-03,Portland Trail Blazers,97,Los Angeles Clippers,117,20,1,0
305,2019-12-04,Golden State Warriors,91,Charlotte Hornets,106,15,1,0
306,2019-12-04,Milwaukee Bucks,127,Detroit Pistons,103,-24,0,1
307,2019-12-04,Phoenix Suns,114,Orlando Magic,128,14,1,0
308,2019-12-04,Brooklyn Nets,130,Atlanta Hawks,118,-12,0,1
309,2019-12-04,Miami Heat,93,Boston Celtics,112,19,1,0
310,2019-12-04,Memphis Grizzlies,99,Chicago Bulls,106,7,1,0
311,2019-12-04,Indiana Pacers,107,Oklahoma City Thunder,100,-7,0,1
312,2019-12-04,Minnesota Timberwolves,114,Dallas Mavericks,121,7,1,0
313,2019-12-04,Los Angeles Lakers,121,Utah Jazz,96,-25,0,1
314,2019-12-04,Sacramento Kings,116,Portland Trail Blazers,127,11,1,0
315,2019-12-05,Philadelphia 76ers,113,Washington Wizards,119,6,1,0
316,2019-12-05,Denver Nuggets,129,New York Knicks,92,-37,0,1
317,2019-12-05,Houston Rockets,119,Toronto Raptors,109,-10,0,1
318,2019-12-05,Phoenix Suns,139,New Orleans Pelicans,132,-7,0,1
319,2019-12-06,Brooklyn Nets,111,Charlotte Hornets,104,-7,0,1
320,2019-12-06,Orlando Magic,93,Cleveland Cavaliers,87,-6,0,1
321,2019-12-06,Indiana Pacers,101,Detroit Pistons,108,7,1,0
322,2019-12-06,Denver Nuggets,95,Boston Celtics,108,13,1,0
323,2019-12-06,Golden State Warriors,100,Chicago Bulls,98,-2,0,1
324,2019-12-06,Washington Wizards,103,Miami Heat,112,9,1,0
325,2019-12-06,Minnesota Timberwolves,127,Oklahoma City Thunder,139,12,1,0
326,2019-12-06,Los Angeles Clippers,91,Milwaukee Bucks,119,28,1,0
327,2019-12-06,Sacramento Kings,104,San Antonio Spurs,105,1,1,0
328,2019-12-06,Los Angeles Lakers,136,Portland Trail Blazers,113,-23,0,1
329,2019-12-07,New Orleans Pelicans,84,Dallas Mavericks,130,46,1,0
330,2019-12-07,Indiana Pacers,104,New York Knicks,103,-1,0,1
331,2019-12-07,Cleveland Cavaliers,94,Philadelphia 76ers,141,47,1,0
332,2019-12-07,Phoenix Suns,109,Houston Rockets,115,6,1,0
333,2019-12-07,Memphis Grizzlies,112,Utah Jazz,126,14,1,0
334,2019-12-08,Denver Nuggets,102,Brooklyn Nets,105,3,1,0
335,2019-12-08,Atlanta Hawks,122,Charlotte Hornets,107,-15,0,1
336,2019-12-08,Chicago Bulls,105,Miami Heat,110,5,1,0
337,2019-12-08,Toronto Raptors,104,Philadelphia 76ers,110,6,1,0
338,2019-12-08,Los Angeles Clippers,135,Washington Wizards,119,-16,0,1
339,2019-12-08,Sacramento Kings,110,Dallas Mavericks,106,-4,0,1
340,2019-12-08,Oklahoma City Thunder,108,Portland Trail Blazers,96,-12,0,1
341,2019-12-08,Minnesota Timberwolves,125,Los Angeles Lakers,142,17,1,0
342,2019-12-09,Los Angeles Clippers,110,Indiana Pacers,99,-11,0,1
343,2019-12-09,Cleveland Cavaliers,88,Boston Celtics,110,22,1,0
344,2019-12-09,Toronto Raptors,93,Chicago Bulls,92,-1,0,1
345,2019-12-09,Sacramento Kings,119,Houston Rockets,118,-1,0,1
346,2019-12-09,Orlando Magic,101,Milwaukee Bucks,110,9,1,0
347,2019-12-09,Detroit Pistons,105,New Orleans Pelicans,103,-2,0,1
348,2019-12-09,Minnesota Timberwolves,109,Phoenix Suns,125,16,1,0
349,2019-12-09,Oklahoma City Thunder,104,Utah Jazz,90,-14,0,1
350,2019-12-09,Memphis Grizzlies,110,Golden State Warriors,102,-8,0,1
351,2019-12-10,Washington Wizards,107,Charlotte Hornets,114,7,1,0
352,2019-12-10,Atlanta Hawks,121,Miami Heat,135,14,1,0
353,2019-12-10,Denver Nuggets,92,Philadelphia 76ers,97,5,1,0
354,2019-12-10,New York Knicks,87,Portland Trail Blazers,115,28,1,0
355,2019-12-11,Houston Rockets,116,Cleveland Cavaliers,110,-6,0,1
356,2019-12-11,Boston Celtics,117,Indiana Pacers,122,5,1,0
357,2019-12-11,Los Angeles Lakers,96,Orlando Magic,87,-9,0,1
358,2019-12-11,Los Angeles Clippers,112,Toronto Raptors,92,-20,0,1
359,2019-12-11,Charlotte Hornets,113,Brooklyn Nets,108,-5,0,1
360,2019-12-11,Atlanta Hawks,102,Chicago Bulls,136,34,1,0
361,2019-12-11,Utah Jazz,127,Minnesota Timberwolves,116,-11,0,1
362,2019-12-11,Memphis Grizzlies,115,Phoenix Suns,108,-7,0,1
363,2019-12-11,New Orleans Pelicans,112,Milwaukee Bucks,127,15,1,0
364,2019-12-11,Oklahoma City Thunder,93,Sacramento Kings,94,1,1,0
365,2019-12-11,New York Knicks,124,Golden State Warriors,122,-2,0,1
366,2019-12-12,Philadelphia 76ers,115,Boston Celtics,109,-6,0,1
367,2019-12-12,Cleveland Cavaliers,117,San Antonio Spurs,109,-8,0,1
368,2019-12-12,Dallas Mavericks,122,Detroit Pistons,111,-11,0,1
369,2019-12-12,Portland Trail Blazers,99,Denver Nuggets,114,15,1,0
370,2019-12-13,Los Angeles Lakers,113,Miami Heat,110,-3,0,1
371,2019-12-13,Houston Rockets,130,Orlando Magic,107,-23,0,1
372,2019-12-13,New Orleans Pelicans,109,Philadelphia 76ers,116,7,1,0
373,2019-12-13,Indiana Pacers,110,Atlanta Hawks,100,-10,0,1
374,2019-12-13,Charlotte Hornets,83,Chicago Bulls,73,-10,0,1
375,2019-12-13,Milwaukee Bucks,127,Memphis Grizzlies,114,-13,0,1
376,2019-12-13,Golden State Warriors,106,Utah Jazz,114,8,1,0
377,2019-12-13,Los Angeles Clippers,124,Minnesota Timberwolves,117,-7,0,1
378,2019-12-13,New York Knicks,103,Sacramento Kings,101,-2,0,1
379,2019-12-14,San Antonio Spurs,121,Phoenix Suns,119,-2,0,1
380,2019-12-14,Brooklyn Nets,102,Toronto Raptors,110,8,1,0
381,2019-12-14,Los Angeles Clippers,106,Chicago Bulls,109,3,1,0
382,2019-12-14,Washington Wizards,111,Memphis Grizzlies,128,17,1,0
383,2019-12-14,Miami Heat,122,Dallas Mavericks,118,-4,0,1
384,2019-12-14,Cleveland Cavaliers,108,Milwaukee Bucks,125,17,1,0
385,2019-12-14,Oklahoma City Thunder,102,Denver Nuggets,110,8,1,0
386,2019-12-14,Detroit Pistons,115,Houston Rockets,107,-8,0,1
387,2019-12-15,Orlando Magic,130,New Orleans Pelicans,119,-11,0,1
388,2019-12-15,Charlotte Hornets,85,Indiana Pacers,107,22,1,0
389,2019-12-15,Los Angeles Lakers,101,Atlanta Hawks,96,-5,0,1
390,2019-12-15,Philadelphia 76ers,89,Brooklyn Nets,109,20,1,0
391,2019-12-15,New York Knicks,105,Denver Nuggets,111,6,1,0
392,2019-12-15,Sacramento Kings,100,Golden State Warriors,79,-21,0,1
393,2019-12-16,Washington Wizards,133,Detroit Pistons,119,-14,0,1
394,2019-12-16,Cleveland Cavaliers,113,Toronto Raptors,133,20,1,0
395,2019-12-16,San Antonio Spurs,107,Houston Rockets,109,2,1,0
396,2019-12-16,Miami Heat,111,Memphis Grizzlies,118,7,1,0
397,2019-12-16,Dallas Mavericks,120,Milwaukee Bucks,116,-4,0,1
398,2019-12-16,Chicago Bulls,106,Oklahoma City Thunder,109,3,1,0
399,2019-12-16,Portland Trail Blazers,111,Phoenix Suns,110,-1,0,1
400,2019-12-17,Sacramento Kings,102,Charlotte Hornets,110,8,1,0
401,2019-12-17,Los Angeles Lakers,102,Indiana Pacers,105,3,1,0
402,2019-12-17,Atlanta Hawks,120,New York Knicks,143,23,1,0
403,2019-12-17,Brooklyn Nets,108,New Orleans Pelicans,101,-7,0,1
404,2019-12-17,Orlando Magic,102,Utah Jazz,109,7,1,0
405,2019-12-17,Phoenix Suns,99,Los Angeles Clippers,120,21,1,0
406,2019-12-18,Charlotte Hornets,98,Cleveland Cavaliers,100,2,1,0
407,2019-12-18,Toronto Raptors,112,Detroit Pistons,99,-13,0,1
408,2019-12-18,Miami Heat,108,Philadelphia 76ers,104,-4,0,1
409,2019-12-18,Chicago Bulls,110,Washington Wizards,109,-1,0,1
410,2019-12-18,New Orleans Pelicans,107,Minnesota Timberwolves,99,-8,0,1
411,2019-12-18,Memphis Grizzlies,122,Oklahoma City Thunder,126,4,1,0
412,2019-12-18,Orlando Magic,104,Denver Nuggets,113,9,1,0
413,2019-12-18,Boston Celtics,109,Dallas Mavericks,103,-6,0,1
414,2019-12-18,Golden State Warriors,112,Portland Trail Blazers,122,10,1,0
415,2019-12-19,Utah Jazz,111,Atlanta Hawks,106,-5,0,1
416,2019-12-19,Los Angeles Lakers,104,Milwaukee Bucks,111,7,1,0
417,2019-12-19,Brooklyn Nets,105,San Antonio Spurs,118,13,1,0
418,2019-12-19,Houston Rockets,122,Los Angeles Clippers,117,-5,0,1
419,2019-12-20,Memphis Grizzlies,107,Cleveland Cavaliers,114,7,1,0
420,2019-12-20,Sacramento Kings,105,Indiana Pacers,119,14,1,0
421,2019-12-20,Detroit Pistons,93,Boston Celtics,114,21,1,0
422,2019-12-20,Washington Wizards,118,Toronto Raptors,122,4,1,0
423,2019-12-20,New York Knicks,114,Miami Heat,129,15,1,0
424,2019-12-20,Phoenix Suns,108,Oklahoma City Thunder,126,18,1,0
425,2019-12-20,Dallas Mavericks,117,Philadelphia 76ers,98,-19,0,1
426,2019-12-20,Minnesota Timberwolves,100,Denver Nuggets,109,9,1,0
427,2019-12-20,Orlando Magic,103,Portland Trail Blazers,118,15,1,0
428,2019-12-20,New Orleans Pelicans,102,Golden State Warriors,106,4,1,0
429,2019-12-21,Utah Jazz,114,Charlotte Hornets,107,-7,0,1
430,2019-12-21,Atlanta Hawks,112,Brooklyn Nets,122,10,1,0
431,2019-12-21,Chicago Bulls,119,Detroit Pistons,107,-12,0,1
432,2019-12-21,Washington Wizards,108,Philadelphia 76ers,125,17,1,0
433,2019-12-21,Milwaukee Bucks,123,New York Knicks,102,-21,0,1
434,2019-12-21,Sacramento Kings,115,Memphis Grizzlies,119,4,1,0
435,2019-12-21,Los Angeles Clippers,134,San Antonio Spurs,109,-25,0,1
436,2019-12-21,Houston Rockets,139,Phoenix Suns,125,-14,0,1
437,2019-12-21,Minnesota Timberwolves,106,Portland Trail Blazers,113,7,1,0
438,2019-12-22,Dallas Mavericks,107,Toronto Raptors,110,3,1,0
439,2019-12-22,Charlotte Hornets,93,Boston Celtics,119,26,1,0
440,2019-12-22,Indiana Pacers,89,Milwaukee Bucks,117,28,1,0
441,2019-12-22,Los Angeles Clippers,112,Oklahoma City Thunder,118,6,1,0
442,2019-12-22,Denver Nuggets,128,Los Angeles Lakers,104,-24,0,1
443,2019-12-23,Atlanta Hawks,118,Cleveland Cavaliers,121,3,1,0
444,2019-12-23,Philadelphia 76ers,125,Detroit Pistons,109,-16,0,1
445,2019-12-23,Toronto Raptors,115,Indiana Pacers,120,5,1,0
446,2019-12-23,Washington Wizards,121,New York Knicks,115,-6,0,1
447,2019-12-23,Chicago Bulls,95,Orlando Magic,103,8,1,0
448,2019-12-23,Utah Jazz,104,Miami Heat,107,3,1,0
449,2019-12-23,San Antonio Spurs,145,Memphis Grizzlies,115,-30,0,1
450,2019-12-23,Denver Nuggets,113,Phoenix Suns,111,-2,0,1
451,2019-12-23,New Orleans Pelicans,102,Portland Trail Blazers,94,-8,0,1
452,2019-12-23,Houston Rockets,113,Sacramento Kings,104,-9,0,1
453,2019-12-23,Minnesota Timberwolves,104,Golden State Warriors,113,9,1,0
454,2019-12-25,Boston Celtics,118,Toronto Raptors,102,-16,0,1
455,2019-12-25,Milwaukee Bucks,109,Philadelphia 76ers,121,12,1,0
456,2019-12-25,Houston Rockets,104,Golden State Warriors,116,12,1,0
457,2019-12-25,Los Angeles Clippers,111,Los Angeles Lakers,106,-5,0,1
458,2019-12-25,New Orleans Pelicans,112,Denver Nuggets,100,-12,0,1
459,2019-12-26,Washington Wizards,102,Detroit Pistons,132,30,1,0
460,2019-12-26,New York Knicks,94,Brooklyn Nets,82,-12,0,1
461,2019-12-26,San Antonio Spurs,98,Dallas Mavericks,102,4,1,0
462,2019-12-26,Memphis Grizzlies,110,Oklahoma City Thunder,97,-13,0,1
463,2019-12-26,Minnesota Timberwolves,105,Sacramento Kings,104,-1,0,1
464,2019-12-26,Portland Trail Blazers,115,Utah Jazz,121,6,1,0
465,2019-12-27,Cleveland Cavaliers,117,Boston Celtics,129,12,1,0
466,2019-12-27,Oklahoma City Thunder,104,Charlotte Hornets,102,-2,0,1
467,2019-12-27,Philadelphia 76ers,97,Orlando Magic,98,1,1,0
468,2019-12-27,Milwaukee Bucks,112,Atlanta Hawks,86,-26,0,1
469,2019-12-27,Indiana Pacers,112,Miami Heat,113,1,1,0
470,2019-12-27,Phoenix Suns,96,Golden State Warriors,105,9,1,0
471,2019-12-28,Memphis Grizzlies,110,Denver Nuggets,119,9,1,0
472,2019-12-28,Toronto Raptors,113,Boston Celtics,97,-16,0,1
473,2019-12-28,Indiana Pacers,98,New Orleans Pelicans,120,22,1,0
474,2019-12-28,Atlanta Hawks,81,Chicago Bulls,116,35,1,0
475,2019-12-28,Brooklyn Nets,98,Houston Rockets,108,10,1,0
476,2019-12-28,Philadelphia 76ers,116,Miami Heat,117,1,1,0
477,2019-12-28,Cleveland Cavaliers,94,Minnesota Timberwolves,88,-6,0,1
478,2019-12-28,New York Knicks,107,Washington Wizards,100,-7,0,1
479,2019-12-28,Dallas Mavericks,141,Golden State Warriors,121,-20,0,1
480,2019-12-28,Orlando Magic,100,Milwaukee Bucks,111,11,1,0
481,2019-12-28,Detroit Pistons,109,San Antonio Spurs,136,27,1,0
482,2019-12-28,Phoenix Suns,112,Sacramento Kings,110,-2,0,1
483,2019-12-28,Los Angeles Lakers,128,Portland Trail Blazers,120,-8,0,1
484,2019-12-28,Utah Jazz,120,Los Angeles Clippers,107,-13,0,1
485,2019-12-29,Oklahoma City Thunder,98,Toronto Raptors,97,-1,0,1
486,2019-12-29,Sacramento Kings,115,Denver Nuggets,120,5,1,0
487,2019-12-29,Charlotte Hornets,104,Memphis Grizzlies,117,13,1,0
488,2019-12-29,Houston Rockets,112,New Orleans Pelicans,127,15,1,0
489,2019-12-29,Dallas Mavericks,95,Los Angeles Lakers,108,13,1,0
490,2019-12-30,Atlanta Hawks,101,Orlando Magic,93,-8,0,1
491,2019-12-30,Miami Heat,105,Washington Wizards,123,18,1,0
492,2019-12-30,Milwaukee Bucks,123,Chicago Bulls,102,-21,0,1
493,2019-12-30,Brooklyn Nets,115,Minnesota Timberwolves,122,7,1,0
494,2019-12-30,Detroit Pistons,81,Utah Jazz,104,23,1,0
495,2019-12-30,Phoenix Suns,122,Portland Trail Blazers,116,-6,0,1
496,2019-12-31,Boston Celtics,109,Charlotte Hornets,92,-17,0,1
497,2019-12-31,Philadelphia 76ers,97,Indiana Pacers,115,18,1,0
498,2019-12-31,Los Angeles Clippers,105,Sacramento Kings,87,-18,0,1
499,2019-12-31,Denver Nuggets,104,Houston Rockets,130,26,1,0
500,2019-12-31,Golden State Warriors,113,San Antonio Spurs,117,4,1,0
501,2019-12-31,Cleveland Cavaliers,97,Toronto Raptors,117,20,1,0
502,2019-12-31,Dallas Mavericks,101,Oklahoma City Thunder,106,5,1,0
503,2020-01-01,Orlando Magic,122,Washington Wizards,101,-21,0,1
504,2020-01-01,Portland Trail Blazers,93,New York Knicks,117,24,1,0
505,2020-01-01,Minnesota Timberwolves,104,Milwaukee Bucks,106,2,1,0
506,2020-01-01,Phoenix Suns,107,Los Angeles Lakers,117,10,1,0
507,2020-01-02,Charlotte Hornets,109,Cleveland Cavaliers,106,-3,0,1
508,2020-01-02,Denver Nuggets,124,Indiana Pacers,116,-8,0,1
509,2020-01-02,Toronto Raptors,76,Miami Heat,84,8,1,0
510,2020-01-02,Utah Jazz,102,Chicago Bulls,98,-4,0,1
511,2020-01-02,Golden State Warriors,84,Minnesota Timberwolves,99,15,1,0
512,2020-01-02,Brooklyn Nets,111,Dallas Mavericks,123,12,1,0
513,2020-01-02,Oklahoma City Thunder,109,San Antonio Spurs,103,-6,0,1
514,2020-01-02,Memphis Grizzlies,123,Sacramento Kings,128,5,1,0
515,2020-01-02,Detroit Pistons,112,Los Angeles Clippers,126,14,1,0
516,2020-01-03,Atlanta Hawks,106,Boston Celtics,109,3,1,0
517,2020-01-03,Miami Heat,85,Orlando Magic,105,20,1,0
518,2020-01-03,Portland Trail Blazers,122,Washington Wizards,103,-19,0,1
519,2020-01-03,Philadelphia 76ers,108,Houston Rockets,118,10,1,0
520,2020-01-03,New York Knicks,112,Phoenix Suns,120,8,1,0
521,2020-01-03,New Orleans Pelicans,113,Los Angeles Lakers,123,10,1,0
522,2020-01-04,Memphis Grizzlies,140,Los Angeles Clippers,114,-26,0,1
523,2020-01-04,Toronto Raptors,121,Brooklyn Nets,102,-19,0,1
524,2020-01-04,Utah Jazz,109,Orlando Magic,96,-13,0,1
525,2020-01-04,Indiana Pacers,111,Atlanta Hawks,116,5,1,0
526,2020-01-04,Oklahoma City Thunder,121,Cleveland Cavaliers,106,-15,0,1
527,2020-01-04,Boston Celtics,111,Chicago Bulls,104,-7,0,1
528,2020-01-04,Denver Nuggets,114,Washington Wizards,128,14,1,0
529,2020-01-04,Charlotte Hornets,123,Dallas Mavericks,120,-3,0,1
530,2020-01-04,Detroit Pistons,111,Golden State Warriors,104,-7,0,1
531,2020-01-04,San Antonio Spurs,118,Milwaukee Bucks,127,9,1,0
532,2020-01-04,New Orleans Pelicans,117,Sacramento Kings,115,-2,0,1
533,2020-01-05,New York Knicks,132,Los Angeles Clippers,135,3,1,0
534,2020-01-05,Portland Trail Blazers,111,Miami Heat,122,11,1,0
535,2020-01-05,Minnesota Timberwolves,118,Cleveland Cavaliers,103,-15,0,1
536,2020-01-05,Memphis Grizzlies,121,Phoenix Suns,114,-7,0,1
537,2020-01-05,Detroit Pistons,99,Los Angeles Lakers,106,7,1,0
538,2020-01-06,Indiana Pacers,115,Charlotte Hornets,104,-11,0,1
539,2020-01-06,Brooklyn Nets,89,Orlando Magic,101,12,1,0
540,2020-01-06,Oklahoma City Thunder,113,Philadelphia 76ers,120,7,1,0
541,2020-01-06,Boston Celtics,94,Washington Wizards,99,5,1,0
542,2020-01-06,Denver Nuggets,123,Atlanta Hawks,115,-8,0,1
543,2020-01-06,Utah Jazz,128,New Orleans Pelicans,126,-2,0,1
544,2020-01-06,Chicago Bulls,110,Dallas Mavericks,118,8,1,0
545,2020-01-06,Milwaukee Bucks,104,San Antonio Spurs,126,22,1,0
546,2020-01-06,Golden State Warriors,98,Sacramento Kings,111,13,1,0
547,2020-01-07,Detroit Pistons,115,Cleveland Cavaliers,113,-2,0,1
548,2020-01-07,Portland Trail Blazers,101,Toronto Raptors,99,-2,0,1
549,2020-01-07,Oklahoma City Thunder,111,Brooklyn Nets,103,-8,0,1
550,2020-01-07,Minnesota Timberwolves,112,Memphis Grizzlies,119,7,1,0
551,2020-01-07,Sacramento Kings,114,Phoenix Suns,103,-11,0,1
552,2020-01-07,New York Knicks,87,Los Angeles Lakers,117,30,1,0
553,2020-01-08,San Antonio Spurs,129,Boston Celtics,114,-15,0,1
554,2020-01-08,Toronto Raptors,112,Charlotte Hornets,110,-2,0,1
555,2020-01-08,Miami Heat,122,Indiana Pacers,108,-14,0,1
556,2020-01-08,Washington Wizards,89,Orlando Magic,123,34,1,0
557,2020-01-08,Houston Rockets,122,Atlanta Hawks,115,-7,0,1
558,2020-01-08,Denver Nuggets,107,Dallas Mavericks,106,-1,0,1
559,2020-01-08,Chicago Bulls,108,New Orleans Pelicans,123,15,1,0
560,2020-01-08,New York Knicks,104,Utah Jazz,128,24,1,0
561,2020-01-08,Milwaukee Bucks,107,Golden State Warriors,98,-9,0,1
562,2020-01-09,Cleveland Cavaliers,115,Detroit Pistons,112,-3,0,1
563,2020-01-09,Boston Celtics,98,Philadelphia 76ers,109,11,1,0
564,2020-01-09,Portland Trail Blazers,102,Minnesota Timberwolves,116,14,1,0
565,2020-01-09,Houston Rockets,92,Oklahoma City Thunder,113,21,1,0
566,2020-01-10,Atlanta Hawks,101,Washington Wizards,111,10,1,0
567,2020-01-10,New Orleans Pelicans,123,New York Knicks,111,-12,0,1
568,2020-01-10,Miami Heat,113,Brooklyn Nets,117,4,1,0
569,2020-01-10,Indiana Pacers,116,Chicago Bulls,105,-11,0,1
570,2020-01-10,San Antonio Spurs,121,Memphis Grizzlies,134,13,1,0
571,2020-01-10,Orlando Magic,94,Phoenix Suns,98,4,1,0
572,2020-01-10,Charlotte Hornets,92,Utah Jazz,109,17,1,0
573,2020-01-10,Los Angeles Lakers,129,Dallas Mavericks,114,-15,0,1
574,2020-01-10,Milwaukee Bucks,127,Sacramento Kings,106,-21,0,1
575,2020-01-10,Golden State Warriors,100,Los Angeles Clippers,109,9,1,0
576,2020-01-11,Minnesota Timberwolves,109,Houston Rockets,139,30,1,0
577,2020-01-11,New Orleans Pelicans,105,Boston Celtics,140,35,1,0
578,2020-01-11,Chicago Bulls,108,Detroit Pistons,99,-9,0,1
579,2020-01-11,Los Angeles Lakers,125,Oklahoma City Thunder,110,-15,0,1
580,2020-01-11,Philadelphia 76ers,91,Dallas Mavericks,109,18,1,0
581,2020-01-11,Cleveland Cavaliers,111,Denver Nuggets,103,-8,0,1
582,2020-01-11,Milwaukee Bucks,122,Portland Trail Blazers,101,-21,0,1
583,2020-01-12,Miami Heat,121,New York Knicks,124,3,1,0
584,2020-01-12,Utah Jazz,127,Washington Wizards,116,-11,0,1
585,2020-01-12,Atlanta Hawks,86,Brooklyn Nets,108,22,1,0
586,2020-01-12,Golden State Warriors,102,Memphis Grizzlies,122,20,1,0
587,2020-01-12,San Antonio Spurs,105,Toronto Raptors,104,-1,0,1
588,2020-01-12,Los Angeles Clippers,104,Denver Nuggets,114,10,1,0
589,2020-01-12,Charlotte Hornets,92,Phoenix Suns,100,8,1,0
590,2020-01-13,New Orleans Pelicans,117,Detroit Pistons,110,-7,0,1
591,2020-01-13,Philadelphia 76ers,95,Indiana Pacers,101,6,1,0
592,2020-01-13,Chicago Bulls,101,Boston Celtics,113,12,1,0
593,2020-01-13,Oklahoma City Thunder,117,Minnesota Timberwolves,104,-13,0,1
594,2020-01-13,Charlotte Hornets,112,Portland Trail Blazers,115,3,1,0
595,2020-01-13,Orlando Magic,114,Sacramento Kings,112,-2,0,1
596,2020-01-13,Cleveland Cavaliers,99,Los Angeles Lakers,128,29,1,0
597,2020-01-14,Phoenix Suns,110,Atlanta Hawks,123,13,1,0
598,2020-01-14,Utah Jazz,118,Brooklyn Nets,107,-11,0,1
599,2020-01-14,Houston Rockets,110,Memphis Grizzlies,121,11,1,0
600,2020-01-14,New York Knicks,102,Milwaukee Bucks,128,26,1,0
601,2020-01-14,Dallas Mavericks,124,Golden State Warriors,97,-27,0,1
602,2020-01-14,Cleveland Cavaliers,103,Los Angeles Clippers,128,25,1,0
603,2020-01-15,Detroit Pistons,116,Boston Celtics,103,-13,0,1
604,2020-01-15,Brooklyn Nets,106,Philadelphia 76ers,117,11,1,0
605,2020-01-15,San Antonio Spurs,100,Miami Heat,106,6,1,0
606,2020-01-15,Washington Wizards,106,Chicago Bulls,115,9,1,0
607,2020-01-15,Indiana Pacers,104,Minnesota Timberwolves,99,-5,0,1
608,2020-01-15,Toronto Raptors,130,Oklahoma City Thunder,121,-9,0,1
609,2020-01-15,Charlotte Hornets,86,Denver Nuggets,100,14,1,0
610,2020-01-15,Portland Trail Blazers,117,Houston Rockets,107,-10,0,1
611,2020-01-15,Dallas Mavericks,127,Sacramento Kings,123,-4,0,1
612,2020-01-15,Orlando Magic,119,Los Angeles Lakers,118,-1,0,1
613,2020-01-16,Phoenix Suns,121,New York Knicks,98,-23,0,1
614,2020-01-16,Boston Celtics,123,Milwaukee Bucks,128,5,1,0
615,2020-01-16,Utah Jazz,132,New Orleans Pelicans,138,6,1,0
616,2020-01-16,Denver Nuggets,134,Golden State Warriors,131,-3,0,1
617,2020-01-16,Orlando Magic,95,Los Angeles Clippers,122,27,1,0
618,2020-01-17,Minnesota Timberwolves,114,Indiana Pacers,116,2,1,0
619,2020-01-17,Chicago Bulls,89,Philadelphia 76ers,100,11,1,0
620,2020-01-17,Washington Wizards,111,Toronto Raptors,140,29,1,0
621,2020-01-17,Cleveland Cavaliers,109,Memphis Grizzlies,113,4,1,0
622,2020-01-17,Miami Heat,115,Oklahoma City Thunder,108,-7,0,1
623,2020-01-17,Atlanta Hawks,121,San Antonio Spurs,120,-1,0,1
624,2020-01-17,Portland Trail Blazers,112,Dallas Mavericks,120,8,1,0
625,2020-01-18,Los Angeles Clippers,133,New Orleans Pelicans,130,-3,0,1
626,2020-01-18,Milwaukee Bucks,117,Brooklyn Nets,97,-20,0,1
627,2020-01-18,Phoenix Suns,123,Boston Celtics,119,-4,0,1
628,2020-01-18,Detroit Pistons,136,Atlanta Hawks,103,-33,0,1
629,2020-01-18,Philadelphia 76ers,90,New York Knicks,87,-3,0,1
630,2020-01-18,Cleveland Cavaliers,116,Chicago Bulls,118,2,1,0
631,2020-01-18,Toronto Raptors,122,Minnesota Timberwolves,112,-10,0,1
632,2020-01-18,Orlando Magic,95,Golden State Warriors,109,14,1,0
633,2020-01-18,Los Angeles Lakers,124,Houston Rockets,115,-9,0,1
634,2020-01-18,Portland Trail Blazers,106,Oklahoma City Thunder,119,13,1,0
635,2020-01-18,Sacramento Kings,101,Utah Jazz,123,22,1,0
636,2020-01-19,Miami Heat,102,San Antonio Spurs,107,5,1,0
637,2020-01-19,Indiana Pacers,115,Denver Nuggets,107,-8,0,1
638,2020-01-20,Detroit Pistons,100,Washington Wizards,106,6,1,0
639,2020-01-20,Toronto Raptors,122,Atlanta Hawks,117,-5,0,1
640,2020-01-20,Philadelphia 76ers,117,Brooklyn Nets,111,-6,0,1
641,2020-01-20,Orlando Magic,106,Charlotte Hornets,83,-23,0,1
642,2020-01-20,New York Knicks,106,Cleveland Cavaliers,86,-20,0,1
643,2020-01-20,Oklahoma City Thunder,112,Houston Rockets,107,-5,0,1
644,2020-01-20,New Orleans Pelicans,126,Memphis Grizzlies,116,-10,0,1
645,2020-01-20,Sacramento Kings,113,Miami Heat,118,5,1,0
646,2020-01-20,Chicago Bulls,98,Milwaukee Bucks,111,13,1,0
647,2020-01-20,Los Angeles Lakers,107,Boston Celtics,139,32,1,0
648,2020-01-20,Denver Nuggets,107,Minnesota Timberwolves,100,-7,0,1
649,2020-01-20,San Antonio Spurs,120,Phoenix Suns,118,-2,0,1
650,2020-01-20,Indiana Pacers,88,Utah Jazz,118,30,1,0
651,2020-01-20,Golden State Warriors,124,Portland Trail Blazers,129,5,1,0
652,2020-01-21,Los Angeles Clippers,110,Dallas Mavericks,107,-3,0,1
653,2020-01-22,Sacramento Kings,106,Detroit Pistons,127,21,1,0
654,2020-01-22,Oklahoma City Thunder,120,Orlando Magic,114,-6,0,1
655,2020-01-22,Philadelphia 76ers,95,Toronto Raptors,107,12,1,0
656,2020-01-22,Los Angeles Clippers,95,Atlanta Hawks,102,7,1,0
657,2020-01-22,Memphis Grizzlies,95,Boston Celtics,119,24,1,0
658,2020-01-22,Washington Wizards,129,Miami Heat,134,5,1,0
659,2020-01-22,Los Angeles Lakers,100,New York Knicks,92,-8,0,1
660,2020-01-22,Minnesota Timberwolves,110,Chicago Bulls,117,7,1,0
661,2020-01-22,Denver Nuggets,105,Houston Rockets,121,16,1,0
662,2020-01-22,Indiana Pacers,112,Phoenix Suns,87,-25,0,1
663,2020-01-22,San Antonio Spurs,121,New Orleans Pelicans,117,-4,0,1
664,2020-01-22,Utah Jazz,129,Golden State Warriors,96,-33,0,1
665,2020-01-23,Washington Wizards,124,Cleveland Cavaliers,112,-12,0,1
666,2020-01-23,Los Angeles Lakers,128,Brooklyn Nets,113,-15,0,1
667,2020-01-23,Dallas Mavericks,133,Portland Trail Blazers,125,-8,0,1
668,2020-01-24,Milwaukee Bucks,116,Charlotte Hornets,103,-13,0,1
669,2020-01-24,Memphis Grizzlies,125,Detroit Pistons,112,-13,0,1
670,2020-01-24,Boston Celtics,109,Orlando Magic,98,-11,0,1
671,2020-01-24,Toronto Raptors,118,New York Knicks,112,-6,0,1
672,2020-01-24,Sacramento Kings,98,Chicago Bulls,81,-17,0,1
673,2020-01-24,Los Angeles Clippers,122,Miami Heat,117,-5,0,1
674,2020-01-24,Houston Rockets,131,Minnesota Timberwolves,124,-7,0,1
675,2020-01-24,Denver Nuggets,113,New Orleans Pelicans,106,-7,0,1
676,2020-01-24,Atlanta Hawks,111,Oklahoma City Thunder,140,29,1,0
677,2020-01-24,Phoenix Suns,103,San Antonio Spurs,99,-4,0,1
678,2020-01-24,Indiana Pacers,129,Golden State Warriors,118,-11,0,1
679,2020-01-25,Dallas Mavericks,107,Utah Jazz,112,5,1,0
680,2020-01-25,Brooklyn Nets,121,Detroit Pistons,111,-10,0,1
681,2020-01-25,Chicago Bulls,118,Cleveland Cavaliers,106,-12,0,1
682,2020-01-25,Oklahoma City Thunder,113,Minnesota Timberwolves,104,-9,0,1
683,2020-01-25,Los Angeles Lakers,91,Philadelphia 76ers,108,17,1,0
684,2020-01-26,Houston Rockets,110,Denver Nuggets,117,7,1,0
685,2020-01-26,Toronto Raptors,110,San Antonio Spurs,106,-4,0,1
686,2020-01-26,Washington Wizards,133,Atlanta Hawks,152,19,1,0
687,2020-01-26,Phoenix Suns,109,Memphis Grizzlies,114,5,1,0
688,2020-01-26,Boston Celtics,108,New Orleans Pelicans,123,15,1,0
689,2020-01-26,Brooklyn Nets,97,New York Knicks,110,13,1,0
690,2020-01-26,Los Angeles Clippers,112,Orlando Magic,97,-15,0,1
691,2020-01-26,Indiana Pacers,129,Portland Trail Blazers,139,10,1,0
692,2020-01-27,Cleveland Cavaliers,115,Detroit Pistons,100,-15,0,1
693,2020-01-27,Orlando Magic,92,Miami Heat,113,21,1,0
694,2020-01-27,San Antonio Spurs,109,Chicago Bulls,110,1,1,0
695,2020-01-27,Sacramento Kings,133,Minnesota Timberwolves,129,-4,0,1
696,2020-01-27,Dallas Mavericks,107,Oklahoma City Thunder,97,-10,0,1
697,2020-01-27,Houston Rockets,126,Utah Jazz,117,-9,0,1
698,2020-01-28,New York Knicks,92,Charlotte Hornets,97,5,1,0
699,2020-01-28,Golden State Warriors,104,Philadelphia 76ers,115,11,1,0
700,2020-01-28,New Orleans Pelicans,125,Cleveland Cavaliers,111,-14,0,1
701,2020-01-28,Atlanta Hawks,114,Toronto Raptors,130,16,1,0
702,2020-01-28,Denver Nuggets,96,Memphis Grizzlies,104,8,1,0
703,2020-01-28,Boston Celtics,109,Miami Heat,101,-8,0,1
704,2020-01-28,Washington Wizards,131,Milwaukee Bucks,151,20,1,0
705,2020-01-28,Phoenix Suns,133,Dallas Mavericks,104,-29,0,1
706,2020-01-29,Chicago Bulls,106,Indiana Pacers,115,9,1,0
707,2020-01-29,Detroit Pistons,115,Brooklyn Nets,125,10,1,0
708,2020-01-29,Memphis Grizzlies,127,New York Knicks,106,-21,0,1
709,2020-01-29,Utah Jazz,120,San Antonio Spurs,127,7,1,0
710,2020-01-29,Houston Rockets,112,Portland Trail Blazers,125,13,1,0
711,2020-01-29,Oklahoma City Thunder,120,Sacramento Kings,100,-20,0,1
712,2020-01-30,Toronto Raptors,115,Cleveland Cavaliers,109,-6,0,1
713,2020-01-30,Charlotte Hornets,107,Washington Wizards,121,14,1,0
714,2020-01-30,Philadelphia 76ers,117,Atlanta Hawks,127,10,1,0
715,2020-01-30,Golden State Warriors,104,Boston Celtics,119,15,1,0
716,2020-01-30,Utah Jazz,100,Denver Nuggets,106,6,1,0
717,2020-01-30,Sacramento Kings,124,Los Angeles Clippers,103,-21,0,1
718,2020-01-31,Toronto Raptors,105,Detroit Pistons,92,-13,0,1
719,2020-01-31,Chicago Bulls,118,Brooklyn Nets,133,15,1,0
720,2020-01-31,Dallas Mavericks,121,Houston Rockets,128,7,1,0
721,2020-01-31,Memphis Grizzlies,111,New Orleans Pelicans,139,28,1,0
722,2020-01-31,Denver Nuggets,127,Milwaukee Bucks,115,-12,0,1
723,2020-01-31,Oklahoma City Thunder,111,Phoenix Suns,107,-4,0,1
724,2020-01-31,Portland Trail Blazers,127,Los Angeles Lakers,119,-8,0,1
725,2020-02-01,Minnesota Timberwolves,106,Los Angeles Clippers,118,12,1,0
726,2020-02-01,New York Knicks,92,Indiana Pacers,85,-7,0,1
727,2020-02-01,Miami Heat,102,Orlando Magic,89,-13,0,1
728,2020-02-01,Golden State Warriors,131,Cleveland Cavaliers,112,-19,0,1
729,2020-02-01,Brooklyn Nets,107,Washington Wizards,113,6,1,0
730,2020-02-01,Philadelphia 76ers,95,Boston Celtics,116,21,1,0
731,2020-02-01,Atlanta Hawks,100,Dallas Mavericks,123,23,1,0
732,2020-02-01,Charlotte Hornets,90,San Antonio Spurs,114,24,1,0
733,2020-02-01,Los Angeles Lakers,129,Sacramento Kings,113,-16,0,1
734,2020-02-01,Utah Jazz,107,Portland Trail Blazers,124,17,1,0
735,2020-02-02,Denver Nuggets,123,Detroit Pistons,128,5,1,0
736,2020-02-02,New Orleans Pelicans,109,Houston Rockets,117,8,1,0
737,2020-02-02,Phoenix Suns,108,Milwaukee Bucks,129,21,1,0
738,2020-02-02,Chicago Bulls,102,Toronto Raptors,129,27,1,0
739,2020-02-03,Orlando Magic,112,Charlotte Hornets,100,-12,0,1
740,2020-02-03,New York Knicks,139,Cleveland Cavaliers,134,-5,0,1
741,2020-02-03,Dallas Mavericks,112,Indiana Pacers,103,-9,0,1
742,2020-02-03,Golden State Warriors,125,Washington Wizards,117,-8,0,1
743,2020-02-03,Boston Celtics,123,Atlanta Hawks,115,-8,0,1
744,2020-02-03,Phoenix Suns,97,Brooklyn Nets,119,22,1,0
745,2020-02-03,Philadelphia 76ers,106,Miami Heat,137,31,1,0
746,2020-02-03,Detroit Pistons,82,Memphis Grizzlies,96,14,1,0
747,2020-02-03,Minnesota Timberwolves,109,Sacramento Kings,113,4,1,0
748,2020-02-03,San Antonio Spurs,105,Los Angeles Clippers,108,3,1,0
749,2020-02-04,Milwaukee Bucks,120,New Orleans Pelicans,108,-12,0,1
750,2020-02-04,Charlotte Hornets,110,Houston Rockets,125,15,1,0
751,2020-02-04,Portland Trail Blazers,99,Denver Nuggets,127,28,1,0
752,2020-02-04,San Antonio Spurs,102,Los Angeles Lakers,129,27,1,0
753,2020-02-05,Phoenix Suns,108,Detroit Pistons,116,8,1,0
754,2020-02-05,Orlando Magic,100,Boston Celtics,116,16,1,0
755,2020-02-05,Golden State Warriors,88,Brooklyn Nets,129,41,1,0
756,2020-02-05,Indiana Pacers,118,Toronto Raptors,119,1,1,0
757,2020-02-05,Atlanta Hawks,127,Minnesota Timberwolves,120,-7,0,1
758,2020-02-05,Cleveland Cavaliers,103,Oklahoma City Thunder,109,6,1,0
759,2020-02-05,Memphis Grizzlies,121,Dallas Mavericks,107,-14,0,1
760,2020-02-05,Denver Nuggets,98,Utah Jazz,95,-3,0,1
761,2020-02-05,Miami Heat,111,Los Angeles Clippers,128,17,1,0
762,2020-02-06,Orlando Magic,103,New York Knicks,105,2,1,0
763,2020-02-06,New Orleans Pelicans,125,Chicago Bulls,119,-6,0,1
764,2020-02-06,Philadelphia 76ers,101,Milwaukee Bucks,112,11,1,0
765,2020-02-06,San Antonio Spurs,117,Portland Trail Blazers,125,8,1,0
766,2020-02-06,Houston Rockets,121,Los Angeles Lakers,111,-10,0,1
767,2020-02-07,Memphis Grizzlies,107,Philadelphia 76ers,119,12,1,0
768,2020-02-07,Dallas Mavericks,118,Washington Wizards,119,1,1,0
769,2020-02-07,Atlanta Hawks,107,Boston Celtics,112,5,1,0
770,2020-02-07,Toronto Raptors,115,Indiana Pacers,106,-9,0,1
771,2020-02-07,Detroit Pistons,101,Oklahoma City Thunder,108,7,1,0
772,2020-02-07,Houston Rockets,91,Phoenix Suns,127,36,1,0
773,2020-02-07,Miami Heat,97,Sacramento Kings,105,8,1,0
774,2020-02-07,Portland Trail Blazers,114,Utah Jazz,117,3,1,0
775,2020-02-08,Milwaukee Bucks,111,Orlando Magic,95,-16,0,1
776,2020-02-08,Dallas Mavericks,116,Charlotte Hornets,100,-16,0,1
777,2020-02-08,New York Knicks,95,Detroit Pistons,92,-3,0,1
778,2020-02-08,New Orleans Pelicans,124,Indiana Pacers,117,-7,0,1
779,2020-02-08,Brooklyn Nets,118,Toronto Raptors,119,1,1,0
780,2020-02-08,Los Angeles Clippers,115,Minnesota Timberwolves,142,27,1,0
781,2020-02-08,Los Angeles Lakers,125,Golden State Warriors,120,-5,0,1
782,2020-02-08,Denver Nuggets,117,Phoenix Suns,108,-9,0,1
783,2020-02-08,San Antonio Spurs,102,Sacramento Kings,122,20,1,0
784,2020-02-09,Boston Celtics,112,Oklahoma City Thunder,111,-1,0,1
785,2020-02-09,New York Knicks,135,Atlanta Hawks,140,5,1,0
786,2020-02-09,Chicago Bulls,111,Philadelphia 76ers,118,7,1,0
787,2020-02-09,Memphis Grizzlies,106,Washington Wizards,99,-7,0,1
788,2020-02-09,Utah Jazz,114,Houston Rockets,113,-1,0,1
789,2020-02-09,Los Angeles Clippers,133,Cleveland Cavaliers,92,-41,0,1
790,2020-02-09,Miami Heat,109,Portland Trail Blazers,115,6,1,0
791,2020-02-10,Charlotte Hornets,87,Detroit Pistons,76,-11,0,1
792,2020-02-10,Brooklyn Nets,106,Indiana Pacers,105,-1,0,1
793,2020-02-10,Atlanta Hawks,126,Orlando Magic,135,9,1,0
794,2020-02-10,Minnesota Timberwolves,126,Toronto Raptors,137,11,1,0
795,2020-02-10,Sacramento Kings,111,Milwaukee Bucks,123,12,1,0
796,2020-02-10,Utah Jazz,123,Dallas Mavericks,119,-4,0,1
797,2020-02-10,San Antonio Spurs,120,Denver Nuggets,127,7,1,0
798,2020-02-10,Miami Heat,113,Golden State Warriors,101,-12,0,1
799,2020-02-10,Phoenix Suns,100,Los Angeles Lakers,125,25,1,0
800,2020-02-11,Los Angeles Clippers,103,Philadelphia 76ers,110,7,1,0
801,2020-02-11,Chicago Bulls,114,Washington Wizards,126,12,1,0
802,2020-02-11,Portland Trail Blazers,117,New Orleans Pelicans,138,21,1,0
803,2020-02-11,San Antonio Spurs,114,Oklahoma City Thunder,106,-8,0,1
804,2020-02-11,Boston Celtics,105,Houston Rockets,116,11,1,0
805,2020-02-12,Atlanta Hawks,105,Cleveland Cavaliers,127,22,1,0
806,2020-02-12,Detroit Pistons,112,Orlando Magic,116,4,1,0
807,2020-02-12,Toronto Raptors,91,Brooklyn Nets,101,10,1,0
808,2020-02-12,Milwaukee Bucks,111,Indiana Pacers,118,7,1,0
809,2020-02-12,Washington Wizards,114,New York Knicks,96,-18,0,1
810,2020-02-12,Portland Trail Blazers,104,Memphis Grizzlies,111,7,1,0
811,2020-02-12,Charlotte Hornets,115,Minnesota Timberwolves,108,-7,0,1
812,2020-02-12,Sacramento Kings,111,Dallas Mavericks,130,19,1,0
813,2020-02-12,Golden State Warriors,106,Phoenix Suns,112,6,1,0
814,2020-02-12,Miami Heat,101,Utah Jazz,116,15,1,0
815,2020-02-12,Los Angeles Lakers,120,Denver Nuggets,116,-4,0,1
816,2020-02-13,Los Angeles Clippers,133,Boston Celtics,141,8,1,0
817,2020-02-13,Oklahoma City Thunder,123,New Orleans Pelicans,118,-5,0,1
818,2020-02-20,Milwaukee Bucks,126,Detroit Pistons,106,-20,0,1
819,2020-02-20,Miami Heat,124,Atlanta Hawks,129,5,1,0
820,2020-02-20,Charlotte Hornets,103,Chicago Bulls,93,-10,0,1
821,2020-02-20,Brooklyn Nets,104,Philadelphia 76ers,112,8,1,0
822,2020-02-20,Memphis Grizzlies,125,Sacramento Kings,129,4,1,0
823,2020-02-20,Houston Rockets,135,Golden State Warriors,105,-30,0,1
824,2020-02-21,Dallas Mavericks,122,Orlando Magic,106,-16,0,1
825,2020-02-21,Cleveland Cavaliers,113,Washington Wizards,108,-5,0,1
826,2020-02-21,Indiana Pacers,106,New York Knicks,98,-8,0,1
827,2020-02-21,Phoenix Suns,101,Toronto Raptors,118,17,1,0
828,2020-02-21,Boston Celtics,127,Minnesota Timberwolves,117,-10,0,1
829,2020-02-21,Denver Nuggets,101,Oklahoma City Thunder,113,12,1,0
830,2020-02-21,San Antonio Spurs,113,Utah Jazz,104,-9,0,1
831,2020-02-21,Memphis Grizzlies,105,Los Angeles Lakers,117,12,1,0
832,2020-02-21,New Orleans Pelicans,128,Portland Trail Blazers,115,-13,0,1
833,2020-02-22,Sacramento Kings,112,Los Angeles Clippers,103,-9,0,1
834,2020-02-22,Brooklyn Nets,115,Charlotte Hornets,86,-29,0,1
835,2020-02-22,Dallas Mavericks,107,Atlanta Hawks,111,4,1,0
836,2020-02-22,Phoenix Suns,112,Chicago Bulls,104,-8,0,1
837,2020-02-22,Cleveland Cavaliers,105,Miami Heat,124,19,1,0
838,2020-02-22,Philadelphia 76ers,98,Milwaukee Bucks,119,21,1,0
839,2020-02-22,Houston Rockets,120,Utah Jazz,110,-10,0,1
840,2020-02-23,Boston Celtics,112,Los Angeles Lakers,114,2,1,0
841,2020-02-23,Minnesota Timberwolves,116,Denver Nuggets,128,12,1,0
842,2020-02-23,Indiana Pacers,81,Toronto Raptors,127,46,1,0
843,2020-02-23,Washington Wizards,117,Chicago Bulls,126,9,1,0
844,2020-02-23,San Antonio Spurs,103,Oklahoma City Thunder,131,28,1,0
845,2020-02-23,New Orleans Pelicans,115,Golden State Warriors,101,-14,0,1
846,2020-02-23,Detroit Pistons,104,Portland Trail Blazers,107,3,1,0
847,2020-02-24,Miami Heat,119,Cleveland Cavaliers,125,6,1,0
848,2020-02-24,Atlanta Hawks,112,Philadelphia 76ers,129,17,1,0
849,2020-02-24,Milwaukee Bucks,137,Washington Wizards,134,-3,0,1
850,2020-02-24,Orlando Magic,115,Brooklyn Nets,113,-2,0,1
851,2020-02-24,New York Knicks,112,Houston Rockets,123,11,1,0
852,2020-02-24,Minnesota Timberwolves,123,Dallas Mavericks,139,16,1,0
853,2020-02-24,Phoenix Suns,131,Utah Jazz,111,-20,0,1
854,2020-02-24,Memphis Grizzlies,97,Los Angeles Clippers,124,27,1,0
855,2020-02-25,Charlotte Hornets,80,Indiana Pacers,119,39,1,0
856,2020-02-25,Milwaukee Bucks,108,Toronto Raptors,97,-11,0,1
857,2020-02-25,Oklahoma City Thunder,124,Chicago Bulls,122,-2,0,1
858,2020-02-25,Detroit Pistons,98,Denver Nuggets,115,17,1,0
859,2020-02-25,New Orleans Pelicans,109,Los Angeles Lakers,118,9,1,0
860,2020-02-25,Boston Celtics,118,Portland Trail Blazers,106,-12,0,1
861,2020-02-25,Sacramento Kings,112,Golden State Warriors,94,-18,0,1
862,2020-02-26,New York Knicks,101,Charlotte Hornets,107,6,1,0
863,2020-02-26,Philadelphia 76ers,94,Cleveland Cavaliers,108,14,1,0
864,2020-02-26,Brooklyn Nets,106,Washington Wizards,110,4,1,0
865,2020-02-26,Orlando Magic,130,Atlanta Hawks,120,-10,0,1
866,2020-02-26,Minnesota Timberwolves,129,Miami Heat,126,-3,0,1
867,2020-02-26,Memphis Grizzlies,112,Houston Rockets,140,28,1,0
868,2020-02-26,Dallas Mavericks,109,San Antonio Spurs,103,-6,0,1
869,2020-02-26,Los Angeles Clippers,102,Phoenix Suns,92,-10,0,1
870,2020-02-26,Boston Celtics,114,Utah Jazz,103,-11,0,1
871,2020-02-27,New York Knicks,106,Philadelphia 76ers,115,9,1,0
872,2020-02-27,Portland Trail Blazers,100,Indiana Pacers,106,6,1,0
873,2020-02-27,Sacramento Kings,108,Oklahoma City Thunder,112,4,1,0
874,2020-02-27,Los Angeles Lakers,116,Golden State Warriors,86,-30,0,1
875,2020-02-28,Minnesota Timberwolves,125,Orlando Magic,136,11,1,0
876,2020-02-28,Brooklyn Nets,118,Atlanta Hawks,141,23,1,0
877,2020-02-28,Charlotte Hornets,99,Toronto Raptors,96,-3,0,1
878,2020-02-28,Sacramento Kings,104,Memphis Grizzlies,101,-3,0,1
879,2020-02-28,Dallas Mavericks,118,Miami Heat,126,8,1,0
880,2020-02-28,Oklahoma City Thunder,86,Milwaukee Bucks,133,47,1,0
881,2020-02-28,Cleveland Cavaliers,104,New Orleans Pelicans,116,12,1,0
882,2020-02-28,Detroit Pistons,113,Phoenix Suns,111,-2,0,1
883,2020-02-28,Washington Wizards,119,Utah Jazz,129,10,1,0
884,2020-02-28,Denver Nuggets,103,Los Angeles Clippers,132,29,1,0
885,2020-02-29,Chicago Bulls,115,New York Knicks,125,10,1,0
886,2020-02-29,Portland Trail Blazers,117,Atlanta Hawks,129,12,1,0
887,2020-02-29,Brooklyn Nets,113,Miami Heat,116,3,1,0
888,2020-02-29,Indiana Pacers,113,Cleveland Cavaliers,104,-9,0,1
889,2020-02-29,Los Angeles Lakers,88,Memphis Grizzlies,105,17,1,0
890,2020-02-29,Houston Rockets,111,Boston Celtics,110,-1,0,1
891,2020-02-29,Orlando Magic,113,San Antonio Spurs,114,1,1,0
892,2020-02-29,Golden State Warriors,115,Phoenix Suns,99,-16,0,1
893,2020-03-01,Milwaukee Bucks,93,Charlotte Hornets,85,-8,0,1
894,2020-03-01,Philadelphia 76ers,130,Los Angeles Clippers,136,6,1,0
895,2020-03-01,Dallas Mavericks,111,Minnesota Timberwolves,91,-20,0,1
896,2020-03-01,Toronto Raptors,118,Denver Nuggets,133,15,1,0
897,2020-03-01,Detroit Pistons,100,Sacramento Kings,106,6,1,0
898,2020-03-01,Los Angeles Lakers,122,New Orleans Pelicans,114,-8,0,1
899,2020-03-01,Washington Wizards,124,Golden State Warriors,110,-14,0,1
900,2020-03-02,Utah Jazz,126,Cleveland Cavaliers,113,-13,0,1
901,2020-03-02,Houston Rockets,123,New York Knicks,125,2,1,0
902,2020-03-02,Portland Trail Blazers,130,Orlando Magic,107,-23,0,1
903,2020-03-02,Memphis Grizzlies,127,Atlanta Hawks,88,-39,0,1
904,2020-03-02,Milwaukee Bucks,89,Miami Heat,105,16,1,0
905,2020-03-02,Dallas Mavericks,107,Chicago Bulls,109,2,1,0
906,2020-03-02,Indiana Pacers,116,San Antonio Spurs,111,-5,0,1
907,2020-03-03,San Antonio Spurs,104,Charlotte Hornets,103,-1,0,1
908,2020-03-03,Brooklyn Nets,129,Boston Celtics,120,-9,0,1
909,2020-03-03,Minnesota Timberwolves,139,New Orleans Pelicans,134,-5,0,1
910,2020-03-03,Los Angeles Clippers,109,Oklahoma City Thunder,94,-15,0,1
911,2020-03-03,Golden State Warriors,116,Denver Nuggets,100,-16,0,1
912,2020-03-03,Toronto Raptors,123,Phoenix Suns,114,-9,0,1
913,2020-03-03,Philadelphia 76ers,107,Los Angeles Lakers,120,13,1,0
914,2020-03-03,Washington Wizards,126,Sacramento Kings,133,7,1,0
915,2020-03-04,Boston Celtics,112,Cleveland Cavaliers,106,-6,0,1
916,2020-03-04,Oklahoma City Thunder,114,Detroit Pistons,107,-7,0,1
917,2020-03-04,Indiana Pacers,100,Milwaukee Bucks,119,19,1,0
918,2020-03-04,Memphis Grizzlies,118,Brooklyn Nets,79,-39,0,1
919,2020-03-04,Utah Jazz,112,New York Knicks,104,-8,0,1
920,2020-03-04,Orlando Magic,113,Miami Heat,116,3,1,0
921,2020-03-04,Chicago Bulls,108,Minnesota Timberwolves,115,7,1,0
922,2020-03-04,New Orleans Pelicans,123,Dallas Mavericks,127,4,1,0
923,2020-03-04,Washington Wizards,104,Portland Trail Blazers,125,21,1,0
924,2020-03-05,Denver Nuggets,114,Charlotte Hornets,112,-2,0,1
925,2020-03-05,Los Angeles Clippers,120,Houston Rockets,105,-15,0,1
926,2020-03-05,Philadelphia 76ers,125,Sacramento Kings,108,-17,0,1
927,2020-03-05,Toronto Raptors,121,Golden State Warriors,113,-8,0,1
928,2020-03-06,Atlanta Hawks,112,Washington Wizards,118,6,1,0
929,2020-03-06,San Antonio Spurs,120,Brooklyn Nets,139,19,1,0
930,2020-03-06,Oklahoma City Thunder,126,New York Knicks,103,-23,0,1
931,2020-03-06,Indiana Pacers,108,Chicago Bulls,102,-6,0,1
932,2020-03-06,Orlando Magic,132,Minnesota Timberwolves,118,-14,0,1
933,2020-03-06,Miami Heat,104,New Orleans Pelicans,110,6,1,0
934,2020-03-06,Utah Jazz,99,Boston Celtics,94,-5,0,1
935,2020-03-06,Memphis Grizzlies,96,Dallas Mavericks,121,25,1,0
936,2020-03-06,Portland Trail Blazers,117,Phoenix Suns,127,10,1,0
937,2020-03-06,Milwaukee Bucks,103,Los Angeles Lakers,113,10,1,0
938,2020-03-07,Houston Rockets,99,Charlotte Hornets,108,9,1,0
939,2020-03-07,Utah Jazz,111,Detroit Pistons,105,-6,0,1
940,2020-03-07,Denver Nuggets,102,Cleveland Cavaliers,104,2,1,0
941,2020-03-07,Atlanta Hawks,101,Memphis Grizzlies,118,17,1,0
942,2020-03-07,Philadelphia 76ers,114,Golden State Warriors,118,4,1,0
943,2020-03-07,Sacramento Kings,123,Portland Trail Blazers,111,-12,0,1
944,2020-03-08,Chicago Bulls,107,Brooklyn Nets,110,3,1,0
945,2020-03-08,New Orleans Pelicans,120,Minnesota Timberwolves,107,-13,0,1
946,2020-03-08,Los Angeles Lakers,112,Los Angeles Clippers,103,-9,0,1
947,2020-03-08,Oklahoma City Thunder,105,Boston Celtics,104,-1,0,1
948,2020-03-08,Milwaukee Bucks,131,Phoenix Suns,140,9,1,0
949,2020-03-08,Miami Heat,100,Washington Wizards,89,-11,0,1
950,2020-03-08,Indiana Pacers,112,Dallas Mavericks,109,-3,0,1
951,2020-03-08,Orlando Magic,126,Houston Rockets,106,-20,0,1
952,2020-03-08,Detroit Pistons,84,New York Knicks,96,12,1,0
953,2020-03-08,San Antonio Spurs,129,Cleveland Cavaliers,132,3,1,0
954,2020-03-08,Toronto Raptors,118,Sacramento Kings,113,-5,0,1
955,2020-03-09,Charlotte Hornets,138,Atlanta Hawks,143,5,1,0
956,2020-03-09,Milwaukee Bucks,95,Denver Nuggets,109,14,1,0
957,2020-03-09,Toronto Raptors,101,Utah Jazz,92,-9,0,1
958,2020-03-10,New York Knicks,115,Washington Wizards,122,7,1,0
959,2020-03-10,Boston Celtics,114,Indiana Pacers,111,-3,0,1
960,2020-03-10,Minnesota Timberwolves,111,Houston Rockets,117,6,1,0
961,2020-03-10,Dallas Mavericks,109,San Antonio Spurs,119,10,1,0
962,2020-03-10,Orlando Magic,120,Memphis Grizzlies,115,-5,0,1
963,2020-03-10,Cleveland Cavaliers,103,Chicago Bulls,108,5,1,0
964,2020-03-10,Phoenix Suns,105,Portland Trail Blazers,121,16,1,0
965,2020-03-10,Brooklyn Nets,104,Los Angeles Lakers,102,-2,0,1
966,2020-03-10,Los Angeles Clippers,131,Golden State Warriors,107,-24,0,1
967,2020-03-11,Detroit Pistons,106,Philadelphia 76ers,124,18,1,0
968,2020-03-11,New York Knicks,136,Atlanta Hawks,131,-5,0,1
969,2020-03-11,Charlotte Hornets,109,Miami Heat,98,-11,0,1
970,2020-03-11,Denver Nuggets,97,Dallas Mavericks,113,16,1,0
971,2020-07-30,Utah Jazz,106,New Orleans Pelicans,104,-2,0,1
972,2020-07-30,Los Angeles Clippers,101,Los Angeles Lakers,103,2,1,0
973,2020-07-31,Orlando Magic,128,Brooklyn Nets,118,-10,0,1
974,2020-07-31,Memphis Grizzlies,135,Portland Trail Blazers,140,5,1,0
975,2020-07-31,Phoenix Suns,125,Washington Wizards,112,-13,0,1
976,2020-07-31,Boston Celtics,112,Milwaukee Bucks,119,7,1,0
977,2020-07-31,Sacramento Kings,120,San Antonio Spurs,129,9,1,0
978,2020-07-31,Houston Rockets,153,Dallas Mavericks,149,-4,0,1
979,2020-08-01,Miami Heat,125,Denver Nuggets,105,-20,0,1
980,2020-08-01,Utah Jazz,94,Oklahoma City Thunder,110,16,1,0
981,2020-08-01,New Orleans Pelicans,103,Los Angeles Clippers,126,23,1,0
982,2020-08-01,Philadelphia 76ers,121,Indiana Pacers,127,6,1,0
983,2020-08-01,Los Angeles Lakers,92,Toronto Raptors,107,15,1,0
984,2020-08-02,Washington Wizards,110,Brooklyn Nets,118,8,1,0
985,2020-08-02,Portland Trail Blazers,124,Boston Celtics,128,4,1,0
986,2020-08-02,San Antonio Spurs,108,Memphis Grizzlies,106,-2,0,1
987,2020-08-02,Sacramento Kings,116,Orlando Magic,132,16,1,0
988,2020-08-02,Milwaukee Bucks,116,Houston Rockets,120,4,1,0
989,2020-08-02,Dallas Mavericks,115,Phoenix Suns,117,2,1,0
990,2020-08-03,Toronto Raptors,107,Miami Heat,103,-4,0,1
991,2020-08-03,Denver Nuggets,121,Oklahoma City Thunder,113,-8,0,1
992,2020-08-03,Indiana Pacers,111,Washington Wizards,100,-11,0,1
993,2020-08-03,Memphis Grizzlies,99,New Orleans Pelicans,109,10,1,0
994,2020-08-03,San Antonio Spurs,130,Philadelphia 76ers,132,2,1,0
995,2020-08-03,Los Angeles Lakers,116,Utah Jazz,108,-8,0,1
996,2020-08-04,Brooklyn Nets,119,Milwaukee Bucks,116,-3,0,1
997,2020-08-04,Dallas Mavericks,114,Sacramento Kings,110,-4,0,1
998,2020-08-04,Phoenix Suns,117,Los Angeles Clippers,115,-2,0,1
999,2020-08-04,Orlando Magic,109,Indiana Pacers,120,11,1,0
1000,2020-08-04,Boston Celtics,106,Miami Heat,112,6,1,0
1001,2020-08-04,Houston Rockets,102,Portland Trail Blazers,110,8,1,0
1002,2020-08-05,Memphis Grizzlies,115,Utah Jazz,124,9,1,0
1003,2020-08-05,Denver Nuggets,132,San Antonio Spurs,126,-6,0,1
1004,2020-08-05,Philadelphia 76ers,107,Washington Wizards,98,-9,0,1
1005,2020-08-05,Oklahoma City Thunder,105,Los Angeles Lakers,86,-19,0,1
1006,2020-08-05,Toronto Raptors,109,Orlando Magic,99,-10,0,1
1007,2020-08-05,Brooklyn Nets,115,Boston Celtics,149,34,1,0
1008,2020-08-06,New Orleans Pelicans,125,Sacramento Kings,140,15,1,0
1009,2020-08-06,Miami Heat,116,Milwaukee Bucks,130,14,1,0
1010,2020-08-06,Indiana Pacers,99,Phoenix Suns,114,15,1,0
1011,2020-08-06,Los Angeles Clippers,126,Dallas Mavericks,111,-15,0,1
1012,2020-08-06,Portland Trail Blazers,125,Denver Nuggets,115,-10,0,1
1013,2020-08-06,Los Angeles Lakers,97,Houston Rockets,113,16,1,0
1014,2020-08-07,Utah Jazz,111,San Antonio Spurs,119,8,1,0
1015,2020-08-07,Oklahoma City Thunder,92,Memphis Grizzlies,121,29,1,0
1016,2020-08-07,Sacramento Kings,106,Brooklyn Nets,119,13,1,0
1017,2020-08-07,Orlando Magic,101,Philadelphia 76ers,108,7,1,0
1018,2020-08-07,Washington Wizards,107,New Orleans Pelicans,118,11,1,0
1019,2020-08-07,Boston Celtics,122,Toronto Raptors,100,-22,0,1
1020,2020-08-08,Los Angeles Clippers,122,Portland Trail Blazers,117,-5,0,1
1021,2020-08-08,Utah Jazz,132,Denver Nuggets,134,2,1,0
1022,2020-08-08,Los Angeles Lakers,111,Indiana Pacers,116,5,1,0
1023,2020-08-08,Phoenix Suns,119,Miami Heat,112,-7,0,1
1024,2020-08-08,Milwaukee Bucks,132,Dallas Mavericks,136,4,1,0
1025,2020-08-09,Washington Wizards,103,Oklahoma City Thunder,121,18,1,0
1026,2020-08-09,Memphis Grizzlies,99,Toronto Raptors,108,9,1,0
1027,2020-08-09,San Antonio Spurs,122,New Orleans Pelicans,113,-9,0,1
1028,2020-08-09,Orlando Magic,119,Boston Celtics,122,3,1,0
1029,2020-08-09,Philadelphia 76ers,121,Portland Trail Blazers,124,3,1,0
1030,2020-08-09,Houston Rockets,129,Sacramento Kings,112,-17,0,1
1031,2020-08-09,Brooklyn Nets,129,Los Angeles Clippers,120,-9,0,1
1032,2020-08-10,Oklahoma City Thunder,101,Phoenix Suns,128,27,1,0
1033,2020-08-10,Dallas Mavericks,122,Utah Jazz,114,-8,0,1
1034,2020-08-10,Toronto Raptors,114,Milwaukee Bucks,106,-8,0,1
1035,2020-08-10,Indiana Pacers,92,Miami Heat,114,22,1,0
1036,2020-08-10,Denver Nuggets,121,Los Angeles Lakers,124,3,1,0
1037,2020-08-11,Brooklyn Nets,108,Orlando Magic,96,-12,0,1
1038,2020-08-11,Houston Rockets,105,San Antonio Spurs,123,18,1,0
1039,2020-08-11,Phoenix Suns,130,Philadelphia 76ers,117,-13,0,1
1040,2020-08-11,Boston Celtics,122,Memphis Grizzlies,107,-15,0,1
1041,2020-08-11,Portland Trail Blazers,134,Dallas Mavericks,131,-3,0,1
1042,2020-08-11,New Orleans Pelicans,106,Sacramento Kings,112,6,1,0
1043,2020-08-11,Milwaukee Bucks,126,Washington Wizards,113,-13,0,1
1044,2020-08-12,Indiana Pacers,108,Houston Rockets,104,-4,0,1
1045,2020-08-12,Toronto Raptors,125,Philadelphia 76ers,121,-4,0,1
1046,2020-08-12,Miami Heat,115,Oklahoma City Thunder,116,1,1,0
1047,2020-08-12,Los Angeles Clippers,124,Denver Nuggets,111,-13,0,1
1048,2020-08-13,Washington Wizards,96,Boston Celtics,90,-6,0,1
1049,2020-08-13,Sacramento Kings,136,Los Angeles Lakers,122,-14,0,1
1050,2020-08-13,Milwaukee Bucks,106,Memphis Grizzlies,119,13,1,0
1051,2020-08-13,Dallas Mavericks,102,Phoenix Suns,128,26,1,0
1052,2020-08-13,San Antonio Spurs,112,Utah Jazz,118,6,1,0
1053,2020-08-13,Portland Trail Blazers,134,Brooklyn Nets,133,-1,0,1
1054,2020-08-13,New Orleans Pelicans,127,Orlando Magic,133,6,1,0
1055,2020-08-14,Denver Nuggets,109,Toronto Raptors,117,8,1,0
1056,2020-08-14,Miami Heat,92,Indiana Pacers,109,17,1,0
1057,2020-08-14,Oklahoma City Thunder,103,Los Angeles Clippers,107,4,1,0
1058,2020-08-14,Philadelphia 76ers,134,Houston Rockets,96,-38,0,1
1059,2020-08-15,Memphis Grizzlies,122,Portland Trail Blazers,126,4,1,0
1060,2020-08-17,Utah Jazz,125,Denver Nuggets,135,10,1,0
1061,2020-08-17,Brooklyn Nets,110,Toronto Raptors,134,24,1,0
1062,2020-08-17,Philadelphia 76ers,101,Boston Celtics,109,8,1,0
1063,2020-08-17,Dallas Mavericks,110,Los Angeles Clippers,118,8,1,0
1064,2020-08-18,Orlando Magic,122,Milwaukee Bucks,110,-12,0,1
1065,2020-08-18,Miami Heat,113,Indiana Pacers,101,-12,0,1
1066,2020-08-18,Oklahoma City Thunder,108,Houston Rockets,123,15,1,0
1067,2020-08-18,Portland Trail Blazers,100,Los Angeles Lakers,93,-7,0,1
1068,2020-08-19,Brooklyn Nets,99,Toronto Raptors,104,5,1,0
1069,2020-08-19,Utah Jazz,124,Denver Nuggets,105,-19,0,1
1070,2020-08-19,Philadelphia 76ers,101,Boston Celtics,128,27,1,0
1071,2020-08-19,Dallas Mavericks,127,Los Angeles Clippers,114,-13,0,1
1072,2020-08-20,Miami Heat,109,Indiana Pacers,100,-9,0,1
1073,2020-08-20,Oklahoma City Thunder,98,Houston Rockets,111,13,1,0
1074,2020-08-20,Orlando Magic,96,Milwaukee Bucks,111,15,1,0
1075,2020-08-20,Portland Trail Blazers,88,Los Angeles Lakers,111,23,1,0
1076,2020-08-21,Toronto Raptors,117,Brooklyn Nets,92,-25,0,1
1077,2020-08-21,Denver Nuggets,87,Utah Jazz,124,37,1,0
1078,2020-08-21,Boston Celtics,102,Philadelphia 76ers,94,-8,0,1
1079,2020-08-21,Los Angeles Clippers,130,Dallas Mavericks,122,-8,0,1
1080,2020-08-22,Milwaukee Bucks,121,Orlando Magic,107,-14,0,1
1081,2020-08-22,Indiana Pacers,115,Miami Heat,124,9,1,0
1082,2020-08-22,Houston Rockets,107,Oklahoma City Thunder,119,12,1,0
1083,2020-08-22,Los Angeles Lakers,116,Portland Trail Blazers,108,-8,0,1
1084,2020-08-23,Boston Celtics,110,Philadelphia 76ers,106,-4,0,1
1085,2020-08-23,Los Angeles Clippers,133,Dallas Mavericks,135,2,1,0
1086,2020-08-23,Toronto Raptors,150,Brooklyn Nets,122,-28,0,1
1087,2020-08-23,Denver Nuggets,127,Utah Jazz,129,2,1,0
1088,2020-08-24,Milwaukee Bucks,121,Orlando Magic,106,-15,0,1
1089,2020-08-24,Houston Rockets,114,Oklahoma City Thunder,117,3,1,0
1090,2020-08-24,Indiana Pacers,87,Miami Heat,99,12,1,0
1091,2020-08-24,Los Angeles Lakers,135,Portland Trail Blazers,115,-20,0,1
1092,2020-08-25,Utah Jazz,107,Denver Nuggets,117,10,1,0
1093,2020-08-25,Dallas Mavericks,111,Los Angeles Clippers,154,43,1,0
1094,2020-08-29,Orlando Magic,104,Milwaukee Bucks,118,14,1,0
1095,2020-08-29,Oklahoma City Thunder,80,Houston Rockets,114,34,1,0
1096,2020-08-29,Portland Trail Blazers,122,Los Angeles Lakers,131,9,1,0
1097,2020-08-30,Boston Celtics,112,Toronto Raptors,94,-18,0,1
1098,2020-08-30,Los Angeles Clippers,111,Dallas Mavericks,97,-14,0,1
1099,2020-08-30,Denver Nuggets,119,Utah Jazz,107,-12,0,1
1100,2020-08-31,Miami Heat,115,Milwaukee Bucks,104,-11,0,1
1101,2020-08-31,Houston Rockets,100,Oklahoma City Thunder,104,4,1,0
1102,2020-09-01,Boston Celtics,102,Toronto Raptors,99,-3,0,1
1103,2020-09-01,Utah Jazz,78,Denver Nuggets,80,2,1,0
1104,2020-09-02,Miami Heat,116,Milwaukee Bucks,114,-2,0,1
1105,2020-09-02,Oklahoma City Thunder,102,Houston Rockets,104,2,1,0
1106,2020-09-03,Toronto Raptors,104,Boston Celtics,103,-1,0,1
1107,2020-09-03,Denver Nuggets,97,Los Angeles Clippers,120,23,1,0
1108,2020-09-04,Milwaukee Bucks,100,Miami Heat,115,15,1,0
1109,2020-09-04,Houston Rockets,112,Los Angeles Lakers,97,-15,0,1
1110,2020-09-05,Toronto Raptors,100,Boston Celtics,93,-7,0,1
1111,2020-09-05,Denver Nuggets,110,Los Angeles Clippers,101,-9,0,1
1112,2020-09-06,Milwaukee Bucks,118,Miami Heat,115,-3,0,1
1113,2020-09-06,Houston Rockets,109,Los Angeles Lakers,117,8,1,0
1114,2020-09-07,Boston Celtics,111,Toronto Raptors,89,-22,0,1
1115,2020-09-07,Los Angeles Clippers,113,Denver Nuggets,107,-6,0,1
1116,2020-09-08,Miami Heat,103,Milwaukee Bucks,94,-9,0,1
1117,2020-09-08,Los Angeles Lakers,112,Houston Rockets,102,-10,0,1
1118,2020-09-09,Toronto Raptors,125,Boston Celtics,122,-3,0,1
1119,2020-09-09,Los Angeles Clippers,96,Denver Nuggets,85,-11,0,1
1120,2020-09-10,Los Angeles Lakers,110,Houston Rockets,100,-10,0,1
1121,2020-09-11,Denver Nuggets,111,Los Angeles Clippers,105,-6,0,1
1122,2020-09-11,Boston Celtics,92,Toronto Raptors,87,-5,0,1
1123,2020-09-12,Houston Rockets,96,Los Angeles Lakers,119,23,1,0
1124,2020-09-13,Los Angeles Clippers,98,Denver Nuggets,111,13,1,0
1125,2020-09-15,Miami Heat,117,Boston Celtics,114,-3,0,1
1126,2020-09-15,Denver Nuggets,104,Los Angeles Clippers,89,-15,0,1
1127,2020-09-17,Miami Heat,106,Boston Celtics,101,-5,0,1
1128,2020-09-18,Denver Nuggets,114,Los Angeles Lakers,126,12,1,0
1129,2020-09-19,Boston Celtics,117,Miami Heat,106,-11,0,1
1130,2020-09-20,Denver Nuggets,103,Los Angeles Lakers,105,2,1,0
1131,2020-09-22,Los Angeles Lakers,106,Denver Nuggets,114,8,1,0
1132,2020-09-23,Boston Celtics,109,Miami Heat,112,3,1,0
1133,2020-09-24,Los Angeles Lakers,114,Denver Nuggets,108,-6,0,1
1134,2020-09-25,Miami Heat,108,Boston Celtics,121,13,1,0
1135,2020-09-26,Denver Nuggets,107,Los Angeles Lakers,117,10,1,0
1136,2020-09-27,Boston Celtics,113,Miami Heat,125,12,1,0
1137,2020-09-30,Miami Heat,98,Los Angeles Lakers,116,18,1,0
1138,2020-10-02,Miami Heat,114,Los Angeles Lakers,124,10,1,0
1139,2020-10-04,Los Angeles Lakers,104,Miami Heat,115,11,1,0
1140,2020-10-06,Los Angeles Lakers,102,Miami Heat,96,-6,0,1
1141,2020-10-09,Miami Heat,111,Los Angeles Lakers,108,-3,0,1
1142,2020-10-11,Los Angeles Lakers,106,Miami Heat,93,-13,0,1
1143,2020-12-22,Golden State Warriors,99,Brooklyn Nets,125,26,1,0
1144,2020-12-22,Los Angeles Clippers,116,Los Angeles Lakers,109,-7,0,1
1145,2020-12-23,Charlotte Hornets,114,Cleveland Cavaliers,121,7,1,0
1146,2020-12-23,New York Knicks,107,Indiana Pacers,121,14,1,0
1147,2020-12-23,Miami Heat,107,Orlando Magic,113,6,1,0
1148,2020-12-23,Washington Wizards,107,Philadelphia 76ers,113,6,1,0
1149,2020-12-23,New Orleans Pelicans,113,Toronto Raptors,99,-14,0,1
1150,2020-12-23,Milwaukee Bucks,121,Boston Celtics,122,1,1,0
1151,2020-12-23,Atlanta Hawks,124,Chicago Bulls,104,-20,0,1
1152,2020-12-23,San Antonio Spurs,131,Memphis Grizzlies,119,-12,0,1
1153,2020-12-23,Detroit Pistons,101,Minnesota Timberwolves,111,10,1,0
1154,2020-12-23,Sacramento Kings,124,Denver Nuggets,122,-2,0,1
1155,2020-12-23,Utah Jazz,120,Portland Trail Blazers,100,-20,0,1
1156,2020-12-23,Dallas Mavericks,102,Phoenix Suns,106,4,1,0
1157,2020-12-25,New Orleans Pelicans,98,Miami Heat,111,13,1,0
1158,2020-12-25,Golden State Warriors,99,Milwaukee Bucks,138,39,1,0
1159,2020-12-25,Brooklyn Nets,123,Boston Celtics,95,-28,0,1
1160,2020-12-25,Dallas Mavericks,115,Los Angeles Lakers,138,23,1,0
1161,2020-12-25,Los Angeles Clippers,121,Denver Nuggets,108,-13,0,1
1162,2020-12-26,Atlanta Hawks,122,Memphis Grizzlies,112,-10,0,1
1163,2020-12-26,Oklahoma City Thunder,109,Charlotte Hornets,107,-2,0,1
1164,2020-12-26,Cleveland Cavaliers,128,Detroit Pistons,119,-9,0,1
1165,2020-12-26,Orlando Magic,130,Washington Wizards,120,-10,0,1
1166,2020-12-26,Philadelphia 76ers,109,New York Knicks,89,-20,0,1
1167,2020-12-26,Indiana Pacers,125,Chicago Bulls,106,-19,0,1
1168,2020-12-26,Toronto Raptors,114,San Antonio Spurs,119,5,1,0
1169,2020-12-26,Minnesota Timberwolves,116,Utah Jazz,111,-5,0,1
1170,2020-12-26,Houston Rockets,126,Portland Trail Blazers,128,2,1,0
1171,2020-12-26,Phoenix Suns,103,Sacramento Kings,106,3,1,0
1172,2020-12-27,Dallas Mavericks,124,Los Angeles Clippers,73,-51,0,1
1173,2020-12-27,San Antonio Spurs,95,New Orleans Pelicans,98,3,1,0
1174,2020-12-27,Orlando Magic,120,Washington Wizards,113,-7,0,1
1175,2020-12-27,Brooklyn Nets,104,Charlotte Hornets,106,2,1,0
1176,2020-12-27,Philadelphia 76ers,94,Cleveland Cavaliers,118,24,1,0
1177,2020-12-27,Milwaukee Bucks,110,New York Knicks,130,20,1,0
1178,2020-12-27,Boston Celtics,107,Indiana Pacers,108,1,1,0
1179,2020-12-27,Golden State Warriors,129,Chicago Bulls,128,-1,0,1
1180,2020-12-27,Phoenix Suns,116,Sacramento Kings,100,-16,0,1
1181,2020-12-27,Minnesota Timberwolves,91,Los Angeles Lakers,127,36,1,0
1182,2020-12-28,Memphis Grizzlies,116,Brooklyn Nets,111,-5,0,1
1183,2020-12-28,Detroit Pistons,120,Atlanta Hawks,128,8,1,0
1184,2020-12-28,Utah Jazz,110,Oklahoma City Thunder,109,-1,0,1
1185,2020-12-28,Houston Rockets,111,Denver Nuggets,124,13,1,0
1186,2020-12-28,Portland Trail Blazers,115,Los Angeles Lakers,107,-8,0,1
1187,2020-12-29,New York Knicks,95,Cleveland Cavaliers,86,-9,0,1
1188,2020-12-29,Golden State Warriors,116,Detroit Pistons,106,-10,0,1
1189,2020-12-29,Boston Celtics,116,Indiana Pacers,111,-5,0,1
1190,2020-12-29,Chicago Bulls,115,Washington Wizards,107,-8,0,1
1191,2020-12-29,Toronto Raptors,93,Philadelphia 76ers,100,7,1,0
1192,2020-12-29,Milwaukee Bucks,144,Miami Heat,97,-47,0,1
1193,2020-12-29,Orlando Magic,118,Oklahoma City Thunder,107,-11,0,1
1194,2020-12-29,New Orleans Pelicans,86,Phoenix Suns,111,25,1,0
1195,2020-12-29,Denver Nuggets,115,Sacramento Kings,125,10,1,0
1196,2020-12-29,Minnesota Timberwolves,101,Los Angeles Clippers,124,23,1,0
1197,2020-12-30,Milwaukee Bucks,108,Miami Heat,119,11,1,0
1198,2020-12-30,Atlanta Hawks,141,Brooklyn Nets,145,4,1,0
1199,2020-12-30,Memphis Grizzlies,107,Boston Celtics,126,19,1,0
1200,2020-12-30,Charlotte Hornets,118,Dallas Mavericks,99,-19,0,1
1201,2020-12-30,Los Angeles Lakers,121,San Antonio Spurs,107,-14,0,1
1202,2020-12-30,Portland Trail Blazers,105,Los Angeles Clippers,128,23,1,0
1203,2020-12-31,Cleveland Cavaliers,99,Indiana Pacers,119,20,1,0
1204,2020-12-31,Chicago Bulls,133,Washington Wizards,130,-3,0,1
1205,2020-12-31,Philadelphia 76ers,116,Orlando Magic,92,-24,0,1
1206,2020-12-31,Sacramento Kings,119,Houston Rockets,122,3,1,0
1207,2020-12-31,New York Knicks,83,Toronto Raptors,100,17,1,0
1208,2020-12-31,New Orleans Pelicans,113,Oklahoma City Thunder,80,-33,0,1
1209,2020-12-31,Phoenix Suns,106,Utah Jazz,95,-11,0,1
1210,2021-01-01,Memphis Grizzlies,108,Charlotte Hornets,93,-15,0,1
1211,2021-01-01,Miami Heat,83,Dallas Mavericks,93,10,1,0
1212,2021-01-01,Boston Celtics,93,Detroit Pistons,96,3,1,0
1213,2021-01-01,Atlanta Hawks,114,Brooklyn Nets,96,-18,0,1
1214,2021-01-01,Chicago Bulls,96,Milwaukee Bucks,126,30,1,0
1215,2021-01-01,Washington Wizards,130,Minnesota Timberwolves,109,-21,0,1
1216,2021-01-01,Los Angeles Lakers,109,San Antonio Spurs,103,-6,0,1
1217,2021-01-01,Phoenix Suns,106,Denver Nuggets,103,-3,0,1
1218,2021-01-01,Los Angeles Clippers,100,Utah Jazz,106,6,1,0
1219,2021-01-01,Portland Trail Blazers,123,Golden State Warriors,98,-25,0,1
1220,2021-01-02,Sacramento Kings,94,Houston Rockets,102,8,1,0
1221,2021-01-02,New York Knicks,106,Indiana Pacers,102,-4,0,1
1222,2021-01-02,Oklahoma City Thunder,108,Orlando Magic,99,-9,0,1
1223,2021-01-02,Charlotte Hornets,112,Philadelphia 76ers,127,15,1,0
1224,2021-01-02,Cleveland Cavaliers,96,Atlanta Hawks,91,-5,0,1
1225,2021-01-02,Toronto Raptors,116,New Orleans Pelicans,120,4,1,0
1226,2021-01-03,Boston Celtics,122,Detroit Pistons,120,-2,0,1
1227,2021-01-03,Washington Wizards,123,Brooklyn Nets,122,-1,0,1
1228,2021-01-03,Los Angeles Lakers,108,Memphis Grizzlies,94,-14,0,1
1229,2021-01-03,Denver Nuggets,124,Minnesota Timberwolves,109,-15,0,1
1230,2021-01-03,Utah Jazz,130,San Antonio Spurs,109,-21,0,1
1231,2021-01-03,Dallas Mavericks,108,Chicago Bulls,118,10,1,0
1232,2021-01-03,Los Angeles Clippers,112,Phoenix Suns,107,-5,0,1
1233,2021-01-03,Portland Trail Blazers,122,Golden State Warriors,137,15,1,0
1234,2021-01-04,Cleveland Cavaliers,83,Orlando Magic,103,20,1,0
1235,2021-01-04,Charlotte Hornets,101,Philadelphia 76ers,118,17,1,0
1236,2021-01-04,New York Knicks,113,Atlanta Hawks,108,-5,0,1
1237,2021-01-04,Oklahoma City Thunder,90,Miami Heat,118,28,1,0
1238,2021-01-04,Boston Celtics,126,Toronto Raptors,114,-12,0,1
1239,2021-01-04,Dallas Mavericks,113,Houston Rockets,100,-13,0,1
1240,2021-01-04,Detroit Pistons,115,Milwaukee Bucks,125,10,1,0
1241,2021-01-04,Indiana Pacers,118,New Orleans Pelicans,116,-2,0,1
1242,2021-01-04,Sacramento Kings,106,Golden State Warriors,137,31,1,0
1243,2021-01-05,Utah Jazz,96,Brooklyn Nets,130,34,1,0
1244,2021-01-05,Los Angeles Lakers,94,Memphis Grizzlies,92,-2,0,1
1245,2021-01-05,Minnesota Timberwolves,116,Denver Nuggets,123,7,1,0
1246,2021-01-05,San Antonio Spurs,116,Los Angeles Clippers,113,-3,0,1
1247,2021-01-05,Chicago Bulls,111,Portland Trail Blazers,108,-3,0,1
1248,2021-01-06,Houston Rockets,107,Indiana Pacers,114,7,1,0
1249,2021-01-06,Cleveland Cavaliers,94,Orlando Magic,105,11,1,0
1250,2021-01-06,Washington Wizards,136,Philadelphia 76ers,141,5,1,0
1251,2021-01-06,Charlotte Hornets,102,Atlanta Hawks,94,-8,0,1
1252,2021-01-06,Boston Celtics,107,Miami Heat,105,-2,0,1
1253,2021-01-06,Utah Jazz,100,New York Knicks,112,12,1,0
1254,2021-01-06,Detroit Pistons,115,Milwaukee Bucks,130,15,1,0
1255,2021-01-06,Oklahoma City Thunder,111,New Orleans Pelicans,110,-1,0,1
1256,2021-01-06,Toronto Raptors,115,Phoenix Suns,123,8,1,0
1257,2021-01-06,Los Angeles Clippers,108,Golden State Warriors,101,-7,0,1
1258,2021-01-06,Chicago Bulls,124,Sacramento Kings,128,4,1,0
1259,2021-01-07,Philadelphia 76ers,109,Brooklyn Nets,122,13,1,0
1260,2021-01-07,Cleveland Cavaliers,94,Memphis Grizzlies,90,-4,0,1
1261,2021-01-07,Dallas Mavericks,124,Denver Nuggets,117,-7,0,1
1262,2021-01-07,San Antonio Spurs,118,Los Angeles Lakers,109,-9,0,1
1263,2021-01-07,Minnesota Timberwolves,117,Portland Trail Blazers,135,18,1,0
1264,2021-01-08,Phoenix Suns,105,Detroit Pistons,110,5,1,0
1265,2021-01-08,Washington Wizards,107,Boston Celtics,116,9,1,0
1266,2021-01-08,Charlotte Hornets,118,New Orleans Pelicans,110,-8,0,1
1267,2021-01-08,Oklahoma City Thunder,101,New York Knicks,89,-12,0,1
1268,2021-01-08,Orlando Magic,90,Houston Rockets,132,42,1,0
1269,2021-01-08,Brooklyn Nets,110,Memphis Grizzlies,115,5,1,0
1270,2021-01-08,Utah Jazz,131,Milwaukee Bucks,118,-13,0,1
1271,2021-01-08,Los Angeles Clippers,105,Golden State Warriors,115,10,1,0
1272,2021-01-08,Chicago Bulls,115,Los Angeles Lakers,117,2,1,0
1273,2021-01-08,Toronto Raptors,144,Sacramento Kings,123,-21,0,1
1274,2021-01-09,Denver Nuggets,115,Philadelphia 76ers,103,-12,0,1
1275,2021-01-09,Atlanta Hawks,105,Charlotte Hornets,113,8,1,0
1276,2021-01-09,Phoenix Suns,125,Indiana Pacers,117,-8,0,1
1277,2021-01-09,Miami Heat,128,Washington Wizards,124,-4,0,1
1278,2021-01-09,Cleveland Cavaliers,90,Milwaukee Bucks,100,10,1,0
1279,2021-01-09,San Antonio Spurs,125,Minnesota Timberwolves,122,-3,0,1
1280,2021-01-09,Orlando Magic,98,Dallas Mavericks,112,14,1,0
1281,2021-01-09,Portland Trail Blazers,125,Sacramento Kings,99,-26,0,1
1282,2021-01-10,Utah Jazz,96,Detroit Pistons,86,-10,0,1
1283,2021-01-10,Chicago Bulls,127,Los Angeles Clippers,130,3,1,0
1284,2021-01-10,Oklahoma City Thunder,129,Brooklyn Nets,116,-13,0,1
1285,2021-01-10,Denver Nuggets,114,New York Knicks,89,-25,0,1
1286,2021-01-10,Los Angeles Lakers,120,Houston Rockets,102,-18,0,1
1287,2021-01-10,San Antonio Spurs,88,Minnesota Timberwolves,96,8,1,0
1288,2021-01-10,Toronto Raptors,105,Golden State Warriors,106,1,1,0
1289,2021-01-11,New York Knicks,88,Charlotte Hornets,109,21,1,0
1290,2021-01-11,Memphis Grizzlies,101,Cleveland Cavaliers,91,-10,0,1
1291,2021-01-11,Milwaukee Bucks,121,Orlando Magic,99,-22,0,1
1292,2021-01-11,Phoenix Suns,107,Washington Wizards,128,21,1,0
1293,2021-01-11,Philadelphia 76ers,94,Atlanta Hawks,112,18,1,0
1294,2021-01-11,Toronto Raptors,111,Portland Trail Blazers,112,1,1,0
1295,2021-01-11,Indiana Pacers,122,Sacramento Kings,127,5,1,0
1296,2021-01-12,Miami Heat,134,Philadelphia 76ers,137,3,1,0
1297,2021-01-12,Denver Nuggets,116,Brooklyn Nets,122,6,1,0
1298,2021-01-12,Utah Jazz,117,Cleveland Cavaliers,87,-30,0,1
1299,2021-01-12,Los Angeles Lakers,117,Houston Rockets,100,-17,0,1
1300,2021-01-12,San Antonio Spurs,112,Oklahoma City Thunder,102,-10,0,1
1301,2021-01-12,Indiana Pacers,104,Golden State Warriors,95,-9,0,1
1302,2021-01-13,Dallas Mavericks,104,Charlotte Hornets,93,-11,0,1
1303,2021-01-13,Milwaukee Bucks,110,Detroit Pistons,101,-9,0,1
1304,2021-01-13,Brooklyn Nets,116,New York Knicks,109,-7,0,1
1305,2021-01-13,Memphis Grizzlies,118,Minnesota Timberwolves,107,-11,0,1
1306,2021-01-13,Los Angeles Lakers,128,Oklahoma City Thunder,99,-29,0,1
1307,2021-01-13,New Orleans Pelicans,106,Los Angeles Clippers,111,5,1,0
1308,2021-01-13,Portland Trail Blazers,132,Sacramento Kings,126,-6,0,1
1309,2021-01-14,Miami Heat,108,Philadelphia 76ers,125,17,1,0
1310,2021-01-14,Houston Rockets,109,San Antonio Spurs,105,-4,0,1
1311,2021-01-14,Charlotte Hornets,108,Toronto Raptors,111,3,1,0
1312,2021-01-14,Golden State Warriors,104,Denver Nuggets,114,10,1,0
1313,2021-01-14,Indiana Pacers,111,Portland Trail Blazers,87,-24,0,1
1314,2021-01-15,Orlando Magic,97,Boston Celtics,124,27,1,0
1315,2021-01-15,New York Knicks,103,Cleveland Cavaliers,106,3,1,0
1316,2021-01-15,Dallas Mavericks,109,Milwaukee Bucks,112,3,1,0
1317,2021-01-15,Chicago Bulls,125,Oklahoma City Thunder,127,2,1,0
1318,2021-01-15,Atlanta Hawks,92,Utah Jazz,116,24,1,0
1319,2021-01-15,New Orleans Pelicans,95,Los Angeles Lakers,112,17,1,0
1320,2021-01-15,Los Angeles Clippers,138,Sacramento Kings,100,-38,0,1
1321,2021-01-16,Houston Rockets,91,San Antonio Spurs,103,12,1,0
1322,2021-01-16,Orlando Magic,115,Brooklyn Nets,122,7,1,0
1323,2021-01-16,Charlotte Hornets,113,Toronto Raptors,116,3,1,0
1324,2021-01-16,Philadelphia 76ers,104,Memphis Grizzlies,106,2,1,0
1325,2021-01-16,Detroit Pistons,120,Miami Heat,100,-20,0,1
1326,2021-01-16,Atlanta Hawks,106,Portland Trail Blazers,112,6,1,0
1327,2021-01-17,New York Knicks,105,Boston Celtics,75,-30,0,1
1328,2021-01-17,Chicago Bulls,117,Dallas Mavericks,101,-16,0,1
1329,2021-01-17,Utah Jazz,109,Denver Nuggets,105,-4,0,1
1330,2021-01-17,New Orleans Pelicans,128,Sacramento Kings,123,-5,0,1
1331,2021-01-17,Indiana Pacers,96,Los Angeles Clippers,129,33,1,0
1332,2021-01-18,Orlando Magic,84,New York Knicks,91,7,1,0
1333,2021-01-18,Minnesota Timberwolves,97,Atlanta Hawks,108,11,1,0
1334,2021-01-18,San Antonio Spurs,125,Portland Trail Blazers,104,-21,0,1
1335,2021-01-18,Phoenix Suns,104,Memphis Grizzlies,108,4,1,0
1336,2021-01-18,Milwaukee Bucks,123,Brooklyn Nets,125,2,1,0
1337,2021-01-18,Dallas Mavericks,93,Toronto Raptors,116,23,1,0
1338,2021-01-18,Houston Rockets,120,Chicago Bulls,125,5,1,0
1339,2021-01-18,Detroit Pistons,107,Miami Heat,113,6,1,0
1340,2021-01-18,Golden State Warriors,115,Los Angeles Lakers,113,-2,0,1
1341,2021-01-19,Oklahoma City Thunder,101,Denver Nuggets,119,18,1,0
1342,2021-01-19,New Orleans Pelicans,102,Utah Jazz,118,16,1,0
1343,2021-01-20,Brooklyn Nets,135,Cleveland Cavaliers,147,12,1,0
1344,2021-01-20,Dallas Mavericks,124,Indiana Pacers,112,-12,0,1
1345,2021-01-20,Boston Celtics,109,Philadelphia 76ers,117,8,1,0
1346,2021-01-20,Detroit Pistons,115,Atlanta Hawks,123,8,1,0
1347,2021-01-20,Miami Heat,111,Toronto Raptors,102,-9,0,1
1348,2021-01-20,Orlando Magic,97,Minnesota Timberwolves,96,-1,0,1
1349,2021-01-20,Phoenix Suns,109,Houston Rockets,103,-6,0,1
1350,2021-01-20,San Antonio Spurs,99,Golden State Warriors,121,22,1,0
1351,2021-01-20,Sacramento Kings,96,Los Angeles Clippers,115,19,1,0
1352,2021-01-21,Los Angeles Lakers,113,Milwaukee Bucks,106,-7,0,1
1353,2021-01-21,New York Knicks,119,Golden State Warriors,104,-15,0,1
1354,2021-01-21,New Orleans Pelicans,118,Utah Jazz,129,11,1,0
1355,2021-01-22,Chicago Bulls,123,Charlotte Hornets,110,-13,0,1
1356,2021-01-22,Houston Rockets,103,Detroit Pistons,102,-1,0,1
1357,2021-01-22,Orlando Magic,118,Indiana Pacers,120,2,1,0
1358,2021-01-22,Brooklyn Nets,113,Cleveland Cavaliers,125,12,1,0
1359,2021-01-22,Boston Celtics,110,Philadelphia 76ers,122,12,1,0
1360,2021-01-22,Miami Heat,81,Toronto Raptors,101,20,1,0
1361,2021-01-22,Atlanta Hawks,116,Minnesota Timberwolves,98,-18,0,1
1362,2021-01-22,Dallas Mavericks,122,San Antonio Spurs,117,-5,0,1
1363,2021-01-22,Oklahoma City Thunder,106,Los Angeles Clippers,120,14,1,0
1364,2021-01-22,Denver Nuggets,130,Phoenix Suns,126,-4,0,1
1365,2021-01-22,New York Knicks,94,Sacramento Kings,103,9,1,0
1366,2021-01-23,Miami Heat,124,Brooklyn Nets,128,4,1,0
1367,2021-01-23,Philadelphia 76ers,114,Detroit Pistons,110,-4,0,1
1368,2021-01-23,New Orleans Pelicans,110,Minnesota Timberwolves,120,10,1,0
1369,2021-01-23,Los Angeles Lakers,101,Chicago Bulls,90,-11,0,1
1370,2021-01-23,Houston Rockets,133,Dallas Mavericks,108,-25,0,1
1371,2021-01-23,Denver Nuggets,120,Phoenix Suns,112,-8,0,1
1372,2021-01-23,Golden State Warriors,108,Utah Jazz,127,19,1,0
1373,2021-01-24,Toronto Raptors,107,Indiana Pacers,102,-5,0,1
1374,2021-01-24,Oklahoma City Thunder,100,Los Angeles Clippers,108,8,1,0
1375,2021-01-24,Cleveland Cavaliers,103,Boston Celtics,141,38,1,0
1376,2021-01-24,Charlotte Hornets,107,Orlando Magic,104,-3,0,1
1377,2021-01-24,Atlanta Hawks,115,Milwaukee Bucks,129,14,1,0
1378,2021-01-24,Washington Wizards,101,San Antonio Spurs,121,20,1,0
1379,2021-01-24,New York Knicks,113,Portland Trail Blazers,116,3,1,0
1380,2021-01-25,Philadelphia 76ers,104,Detroit Pistons,119,15,1,0
1381,2021-01-25,Toronto Raptors,114,Indiana Pacers,129,15,1,0
1382,2021-01-25,Charlotte Hornets,108,Orlando Magic,117,9,1,0
1383,2021-01-25,Miami Heat,85,Brooklyn Nets,98,13,1,0
1384,2021-01-25,Los Angeles Lakers,115,Cleveland Cavaliers,108,-7,0,1
1385,2021-01-25,Denver Nuggets,117,Dallas Mavericks,113,-4,0,1
1386,2021-01-25,Boston Celtics,119,Chicago Bulls,103,-16,0,1
1387,2021-01-25,Minnesota Timberwolves,108,Golden State Warriors,130,22,1,0
1388,2021-01-25,Oklahoma City Thunder,125,Portland Trail Blazers,122,-3,0,1
1389,2021-01-26,Los Angeles Clippers,99,Atlanta Hawks,108,9,1,0
1390,2021-01-26,Washington Wizards,88,Houston Rockets,107,19,1,0
1391,2021-01-26,New York Knicks,94,Utah Jazz,108,14,1,0
1392,2021-01-27,Indiana Pacers,116,Charlotte Hornets,106,-10,0,1
1393,2021-01-27,Detroit Pistons,107,Cleveland Cavaliers,122,15,1,0
1394,2021-01-27,Sacramento Kings,121,Orlando Magic,107,-14,0,1
1395,2021-01-27,Brooklyn Nets,132,Atlanta Hawks,128,-4,0,1
1396,2021-01-27,Denver Nuggets,109,Miami Heat,82,-27,0,1
1397,2021-01-27,Los Angeles Lakers,106,Philadelphia 76ers,107,1,1,0
1398,2021-01-27,Milwaukee Bucks,115,Toronto Raptors,108,-7,0,1
1399,2021-01-27,Boston Celtics,106,San Antonio Spurs,110,4,1,0
1400,2021-01-27,Washington Wizards,106,New Orleans Pelicans,124,18,1,0
1401,2021-01-27,Oklahoma City Thunder,102,Phoenix Suns,97,-5,0,1
1402,2021-01-27,Dallas Mavericks,104,Utah Jazz,116,12,1,0
1403,2021-01-27,Minnesota Timberwolves,111,Golden State Warriors,123,12,1,0
1404,2021-01-28,Portland Trail Blazers,101,Houston Rockets,104,3,1,0
1405,2021-01-28,Los Angeles Lakers,92,Detroit Pistons,107,15,1,0
1406,2021-01-28,Los Angeles Clippers,109,Miami Heat,105,-4,0,1
1407,2021-01-28,Golden State Warriors,93,Phoenix Suns,114,21,1,0
1408,2021-01-29,Indiana Pacers,105,Charlotte Hornets,108,3,1,0
1409,2021-01-29,Atlanta Hawks,116,Washington Wizards,100,-16,0,1
1410,2021-01-29,Milwaukee Bucks,126,New Orleans Pelicans,131,5,1,0
1411,2021-01-29,Cleveland Cavaliers,81,New York Knicks,102,21,1,0
1412,2021-01-29,Sacramento Kings,126,Toronto Raptors,124,-2,0,1
1413,2021-01-29,Philadelphia 76ers,118,Minnesota Timberwolves,94,-24,0,1
1414,2021-01-29,Brooklyn Nets,147,Oklahoma City Thunder,125,-22,0,1
1415,2021-01-29,Los Angeles Clippers,116,Orlando Magic,90,-26,0,1
1416,2021-01-29,Denver Nuggets,109,San Antonio Spurs,119,10,1,0
1417,2021-01-29,Dallas Mavericks,101,Utah Jazz,120,19,1,0
1418,2021-01-30,Portland Trail Blazers,123,Chicago Bulls,122,-1,0,1
1419,2021-01-30,Milwaukee Bucks,114,Charlotte Hornets,126,12,1,0
1420,2021-01-30,Sacramento Kings,104,Miami Heat,105,1,1,0
1421,2021-01-30,Houston Rockets,126,New Orleans Pelicans,112,-14,0,1
1422,2021-01-30,Los Angeles Lakers,96,Boston Celtics,95,-1,0,1
1423,2021-01-30,Memphis Grizzlies,129,San Antonio Spurs,112,-17,0,1
1424,2021-01-30,Phoenix Suns,111,Dallas Mavericks,105,-6,0,1
1425,2021-01-30,Detroit Pistons,91,Golden State Warriors,118,27,1,0
1426,2021-01-31,Los Angeles Clippers,129,New York Knicks,115,-14,0,1
1427,2021-01-31,Utah Jazz,117,Denver Nuggets,128,11,1,0
1428,2021-01-31,Philadelphia 76ers,119,Indiana Pacers,110,-9,0,1
1429,2021-01-31,Orlando Magic,102,Toronto Raptors,115,13,1,0
1430,2021-01-31,Brooklyn Nets,146,Washington Wizards,149,3,1,0
1431,2021-01-31,Cleveland Cavaliers,104,Minnesota Timberwolves,109,5,1,0
1432,2021-02-01,Los Angeles Lakers,107,Atlanta Hawks,99,-8,0,1
1433,2021-02-01,Charlotte Hornets,129,Miami Heat,121,-8,0,1
1434,2021-02-01,New York Knicks,102,Chicago Bulls,110,8,1,0
1435,2021-02-01,Minnesota Timberwolves,98,Cleveland Cavaliers,100,2,1,0
1436,2021-02-01,Portland Trail Blazers,106,Milwaukee Bucks,134,28,1,0
1437,2021-02-01,Sacramento Kings,118,New Orleans Pelicans,109,-9,0,1
1438,2021-02-01,Houston Rockets,136,Oklahoma City Thunder,106,-30,0,1
1439,2021-02-01,Phoenix Suns,109,Dallas Mavericks,108,-1,0,1
1440,2021-02-01,Memphis Grizzlies,133,San Antonio Spurs,102,-31,0,1
1441,2021-02-02,Toronto Raptors,123,Orlando Magic,108,-15,0,1
1442,2021-02-02,Los Angeles Clippers,120,Brooklyn Nets,124,4,1,0
1443,2021-02-02,Memphis Grizzlies,116,Indiana Pacers,134,18,1,0
1444,2021-02-02,Portland Trail Blazers,132,Washington Wizards,121,-11,0,1
1445,2021-02-02,Boston Celtics,111,Golden State Warriors,107,-4,0,1
1446,2021-02-02,Detroit Pistons,105,Utah Jazz,117,12,1,0
1447,2021-02-03,Philadelphia 76ers,118,Charlotte Hornets,111,-7,0,1
1448,2021-02-03,Indiana Pacers,110,Milwaukee Bucks,130,20,1,0
1449,2021-02-03,Dallas Mavericks,122,Atlanta Hawks,116,-6,0,1
1450,2021-02-03,New York Knicks,107,Chicago Bulls,103,-4,0,1
1451,2021-02-03,Los Angeles Clippers,121,Cleveland Cavaliers,99,-22,0,1
1452,2021-02-03,Washington Wizards,103,Miami Heat,100,-3,0,1
1453,2021-02-03,Houston Rockets,87,Oklahoma City Thunder,104,17,1,0
1454,2021-02-03,Minnesota Timberwolves,108,San Antonio Spurs,111,3,1,0
1455,2021-02-03,Phoenix Suns,101,New Orleans Pelicans,123,22,1,0
1456,2021-02-03,Boston Celtics,111,Sacramento Kings,116,5,1,0
1457,2021-02-04,Utah Jazz,112,Atlanta Hawks,91,-21,0,1
1458,2021-02-04,Golden State Warriors,147,Dallas Mavericks,116,-31,0,1
1459,2021-02-04,Portland Trail Blazers,121,Philadelphia 76ers,105,-16,0,1
1460,2021-02-04,Houston Rockets,115,Memphis Grizzlies,103,-12,0,1
1461,2021-02-04,Denver Nuggets,93,Los Angeles Lakers,114,21,1,0
1462,2021-02-05,New Orleans Pelicans,114,Indiana Pacers,113,-1,0,1
1463,2021-02-05,Chicago Bulls,119,Orlando Magic,123,4,1,0
1464,2021-02-05,Toronto Raptors,123,Brooklyn Nets,117,-6,0,1
1465,2021-02-05,Milwaukee Bucks,123,Cleveland Cavaliers,105,-18,0,1
1466,2021-02-05,Utah Jazz,138,Charlotte Hornets,121,-17,0,1
1467,2021-02-05,Washington Wizards,95,Miami Heat,122,27,1,0
1468,2021-02-05,Minnesota Timberwolves,106,Oklahoma City Thunder,103,-3,0,1
1469,2021-02-05,Detroit Pistons,92,Phoenix Suns,109,17,1,0
1470,2021-02-05,Boston Celtics,119,Los Angeles Clippers,115,-4,0,1
1471,2021-02-06,Portland Trail Blazers,99,New York Knicks,110,11,1,0
1472,2021-02-06,Denver Nuggets,114,Sacramento Kings,119,5,1,0
1473,2021-02-06,Chicago Bulls,118,Orlando Magic,92,-26,0,1
1474,2021-02-06,Toronto Raptors,121,Atlanta Hawks,132,11,1,0
1475,2021-02-06,Milwaukee Bucks,124,Cleveland Cavaliers,99,-25,0,1
1476,2021-02-06,San Antonio Spurs,111,Houston Rockets,106,-5,0,1
1477,2021-02-06,Minnesota Timberwolves,118,Oklahoma City Thunder,120,2,1,0
1478,2021-02-06,Brooklyn Nets,108,Philadelphia 76ers,124,16,1,0
1479,2021-02-06,Golden State Warriors,132,Dallas Mavericks,134,2,1,0
1480,2021-02-06,Memphis Grizzlies,109,New Orleans Pelicans,118,9,1,0
1481,2021-02-06,Detroit Pistons,129,Los Angeles Lakers,135,6,1,0
1482,2021-02-07,Washington Wizards,97,Charlotte Hornets,119,22,1,0
1483,2021-02-07,Utah Jazz,103,Indiana Pacers,95,-8,0,1
1484,2021-02-07,Miami Heat,109,New York Knicks,103,-6,0,1
1485,2021-02-07,Boston Celtics,91,Phoenix Suns,100,9,1,0
1486,2021-02-07,Sacramento Kings,113,Los Angeles Clippers,110,-3,0,1
1487,2021-02-08,Houston Rockets,94,Charlotte Hornets,119,25,1,0
1488,2021-02-08,Washington Wizards,105,Chicago Bulls,101,-4,0,1
1489,2021-02-08,Toronto Raptors,128,Memphis Grizzlies,113,-15,0,1
1490,2021-02-08,Minnesota Timberwolves,122,Dallas Mavericks,127,5,1,0
1491,2021-02-08,Golden State Warriors,100,San Antonio Spurs,105,5,1,0
1492,2021-02-08,Cleveland Cavaliers,113,Phoenix Suns,119,6,1,0
1493,2021-02-08,Milwaukee Bucks,125,Denver Nuggets,112,-13,0,1
1494,2021-02-08,Oklahoma City Thunder,112,Los Angeles Lakers,119,7,1,0
1495,2021-02-09,Brooklyn Nets,111,Detroit Pistons,122,11,1,0
1496,2021-02-09,New York Knicks,96,Miami Heat,98,2,1,0
1497,2021-02-09,Houston Rockets,101,New Orleans Pelicans,130,29,1,0
1498,2021-02-09,Golden State Warriors,114,San Antonio Spurs,91,-23,0,1
1499,2021-02-09,Orlando Magic,97,Portland Trail Blazers,106,9,1,0
1500,2021-02-09,Philadelphia 76ers,119,Sacramento Kings,111,-8,0,1
1501,2021-02-09,Boston Celtics,108,Utah Jazz,122,14,1,0
1502,2021-02-10,Toronto Raptors,137,Washington Wizards,115,-22,0,1
1503,2021-02-10,Atlanta Hawks,117,Dallas Mavericks,118,1,1,0
1504,2021-02-10,Indiana Pacers,94,Brooklyn Nets,104,10,1,0
1505,2021-02-10,Charlotte Hornets,114,Memphis Grizzlies,130,16,1,0
1506,2021-02-10,Los Angeles Clippers,119,Minnesota Timberwolves,112,-7,0,1
1507,2021-02-10,New Orleans Pelicans,116,Chicago Bulls,129,13,1,0
1508,2021-02-10,Cleveland Cavaliers,95,Denver Nuggets,133,38,1,0
1509,2021-02-10,Oklahoma City Thunder,113,Los Angeles Lakers,114,1,1,0
1510,2021-02-10,Milwaukee Bucks,124,Phoenix Suns,125,1,1,0
1511,2021-02-11,Toronto Raptors,106,Boston Celtics,120,14,1,0
1512,2021-02-11,Miami Heat,101,Houston Rockets,94,-7,0,1
1513,2021-02-11,Indiana Pacers,111,Detroit Pistons,95,-16,0,1
1514,2021-02-11,Orlando Magic,105,Golden State Warriors,111,6,1,0
1515,2021-02-11,Philadelphia 76ers,114,Portland Trail Blazers,118,4,1,0
1516,2021-02-12,Minnesota Timberwolves,114,Charlotte Hornets,120,6,1,0
1517,2021-02-12,New York Knicks,109,Washington Wizards,91,-18,0,1
1518,2021-02-12,San Antonio Spurs,125,Atlanta Hawks,114,-11,0,1
1519,2021-02-12,New Orleans Pelicans,130,Dallas Mavericks,143,13,1,0
1520,2021-02-12,Detroit Pistons,108,Boston Celtics,102,-6,0,1
1521,2021-02-12,Los Angeles Clippers,125,Chicago Bulls,106,-19,0,1
1522,2021-02-12,Oklahoma City Thunder,95,Denver Nuggets,97,2,1,0
1523,2021-02-12,Milwaukee Bucks,115,Utah Jazz,129,14,1,0
1524,2021-02-12,Memphis Grizzlies,105,Los Angeles Lakers,115,10,1,0
1525,2021-02-12,Cleveland Cavaliers,110,Portland Trail Blazers,129,19,1,0
1526,2021-02-12,Orlando Magic,123,Sacramento Kings,112,-11,0,1
1527,2021-02-13,Philadelphia 76ers,111,Phoenix Suns,120,9,1,0
1528,2021-02-13,Indiana Pacers,125,Atlanta Hawks,113,-12,0,1
1529,2021-02-13,Houston Rockets,99,New York Knicks,121,22,1,0
1530,2021-02-13,Brooklyn Nets,134,Golden State Warriors,117,-17,0,1
1531,2021-02-13,Miami Heat,94,Utah Jazz,112,18,1,0
1532,2021-02-14,Boston Celtics,91,Washington Wizards,104,13,1,0
1533,2021-02-14,San Antonio Spurs,122,Charlotte Hornets,110,-12,0,1
1534,2021-02-14,New Orleans Pelicans,112,Detroit Pistons,123,11,1,0
1535,2021-02-14,Minnesota Timberwolves,116,Toronto Raptors,112,-4,0,1
1536,2021-02-14,Portland Trail Blazers,121,Dallas Mavericks,118,-3,0,1
1537,2021-02-14,Milwaukee Bucks,109,Oklahoma City Thunder,114,5,1,0
1538,2021-02-14,Orlando Magic,90,Phoenix Suns,109,19,1,0
1539,2021-02-14,Los Angeles Lakers,105,Denver Nuggets,122,17,1,0
1540,2021-02-14,Cleveland Cavaliers,111,Los Angeles Clippers,128,17,1,0
1541,2021-02-14,Memphis Grizzlies,124,Sacramento Kings,110,-14,0,1
1542,2021-02-15,Chicago Bulls,120,Indiana Pacers,112,-8,0,1
1543,2021-02-15,Houston Rockets,119,Washington Wizards,131,12,1,0
1544,2021-02-15,Atlanta Hawks,112,New York Knicks,123,11,1,0
1545,2021-02-15,Philadelphia 76ers,123,Utah Jazz,134,11,1,0
1546,2021-02-15,Cleveland Cavaliers,98,Golden State Warriors,129,31,1,0
1547,2021-02-15,Miami Heat,118,Los Angeles Clippers,125,7,1,0
1548,2021-02-15,Brooklyn Nets,136,Sacramento Kings,125,-11,0,1
1549,2021-02-16,Denver Nuggets,99,Boston Celtics,112,13,1,0
1550,2021-02-16,New Orleans Pelicans,144,Memphis Grizzlies,113,-31,0,1
1551,2021-02-16,Toronto Raptors,124,Milwaukee Bucks,113,-11,0,1
1552,2021-02-16,Los Angeles Lakers,112,Minnesota Timberwolves,104,-8,0,1
1553,2021-02-16,Portland Trail Blazers,115,Oklahoma City Thunder,104,-11,0,1
1554,2021-02-16,Brooklyn Nets,128,Phoenix Suns,124,-4,0,1
1555,2021-02-17,New York Knicks,89,Orlando Magic,107,18,1,0
1556,2021-02-17,Atlanta Hawks,122,Boston Celtics,114,-8,0,1
1557,2021-02-17,Houston Rockets,113,Philadelphia 76ers,118,5,1,0
1558,2021-02-17,Detroit Pistons,102,Chicago Bulls,105,3,1,0
1559,2021-02-17,Indiana Pacers,134,Minnesota Timberwolves,128,-6,0,1
1560,2021-02-17,Denver Nuggets,128,Washington Wizards,130,2,1,0
1561,2021-02-17,Oklahoma City Thunder,113,Memphis Grizzlies,122,9,1,0
1562,2021-02-17,Portland Trail Blazers,126,New Orleans Pelicans,124,-2,0,1
1563,2021-02-17,Miami Heat,112,Golden State Warriors,120,8,1,0
1564,2021-02-17,Utah Jazz,114,Los Angeles Clippers,96,-18,0,1
1565,2021-02-18,Toronto Raptors,110,Milwaukee Bucks,96,-14,0,1
1566,2021-02-18,Brooklyn Nets,109,Los Angeles Lakers,98,-11,0,1
1567,2021-02-18,Miami Heat,118,Sacramento Kings,110,-8,0,1
1568,2021-02-19,Denver Nuggets,120,Cleveland Cavaliers,103,-17,0,1
1569,2021-02-19,Golden State Warriors,120,Orlando Magic,124,4,1,0
1570,2021-02-19,Atlanta Hawks,109,Boston Celtics,121,12,1,0
1571,2021-02-19,Chicago Bulls,105,Philadelphia 76ers,112,7,1,0
1572,2021-02-19,Detroit Pistons,95,Memphis Grizzlies,109,14,1,0
1573,2021-02-19,Oklahoma City Thunder,85,Milwaukee Bucks,98,13,1,0
1574,2021-02-19,Phoenix Suns,132,New Orleans Pelicans,114,-18,0,1
1575,2021-02-19,Toronto Raptors,86,Minnesota Timberwolves,81,-5,0,1
1576,2021-02-19,Utah Jazz,112,Los Angeles Clippers,116,4,1,0
1577,2021-02-20,Golden State Warriors,100,Charlotte Hornets,102,2,1,0
1578,2021-02-20,Miami Heat,96,Los Angeles Lakers,94,-2,0,1
1579,2021-02-20,Sacramento Kings,114,Chicago Bulls,122,8,1,0
1580,2021-02-20,Phoenix Suns,128,Memphis Grizzlies,97,-31,0,1
1581,2021-02-20,Washington Wizards,118,Portland Trail Blazers,111,-7,0,1
1582,2021-02-21,Boston Celtics,115,New Orleans Pelicans,120,5,1,0
1583,2021-02-21,Oklahoma City Thunder,117,Cleveland Cavaliers,101,-16,0,1
1584,2021-02-21,Minnesota Timberwolves,99,New York Knicks,103,4,1,0
1585,2021-02-21,Detroit Pistons,96,Orlando Magic,105,9,1,0
1586,2021-02-21,Philadelphia 76ers,103,Toronto Raptors,110,7,1,0
1587,2021-02-21,Denver Nuggets,115,Atlanta Hawks,123,8,1,0
1588,2021-02-21,Brooklyn Nets,112,Los Angeles Clippers,108,-4,0,1
1589,2021-02-21,Sacramento Kings,115,Milwaukee Bucks,128,13,1,0
1590,2021-02-22,Chicago Bulls,120,Houston Rockets,100,-20,0,1
1591,2021-02-22,Memphis Grizzlies,92,Dallas Mavericks,102,10,1,0
1592,2021-02-22,Miami Heat,108,Oklahoma City Thunder,94,-14,0,1
1593,2021-02-22,Portland Trail Blazers,100,Phoenix Suns,132,32,1,0
1594,2021-02-22,Charlotte Hornets,110,Utah Jazz,132,22,1,0
1595,2021-02-22,Washington Wizards,127,Los Angeles Lakers,124,-3,0,1
1596,2021-02-23,Atlanta Hawks,111,Cleveland Cavaliers,112,1,1,0
1597,2021-02-23,Detroit Pistons,105,Orlando Magic,93,-12,0,1
1598,2021-02-23,Sacramento Kings,118,Brooklyn Nets,127,9,1,0
1599,2021-02-23,Boston Celtics,107,Dallas Mavericks,110,3,1,0
1600,2021-02-23,Golden State Warriors,114,New York Knicks,106,-8,0,1
1601,2021-02-23,Philadelphia 76ers,109,Toronto Raptors,102,-7,0,1
1602,2021-02-23,Minnesota Timberwolves,112,Milwaukee Bucks,139,27,1,0
1603,2021-02-23,Portland Trail Blazers,106,Denver Nuggets,111,5,1,0
1604,2021-02-23,Washington Wizards,116,Los Angeles Clippers,135,19,1,0
1605,2021-02-24,Boston Celtics,112,Atlanta Hawks,127,15,1,0
1606,2021-02-24,Houston Rockets,96,Cleveland Cavaliers,112,16,1,0
1607,2021-02-24,Golden State Warriors,111,Indiana Pacers,107,-4,0,1
1608,2021-02-24,Minnesota Timberwolves,126,Chicago Bulls,133,7,1,0
1609,2021-02-24,Toronto Raptors,108,Miami Heat,116,8,1,0
1610,2021-02-24,Detroit Pistons,118,New Orleans Pelicans,128,10,1,0
1611,2021-02-24,San Antonio Spurs,99,Oklahoma City Thunder,102,3,1,0
1612,2021-02-24,Charlotte Hornets,124,Phoenix Suns,121,-3,0,1
1613,2021-02-24,Los Angeles Lakers,89,Utah Jazz,114,25,1,0
1614,2021-02-25,Dallas Mavericks,97,Philadelphia 76ers,111,14,1,0
1615,2021-02-25,Orlando Magic,92,Brooklyn Nets,129,37,1,0
1616,2021-02-25,Sacramento Kings,121,New York Knicks,140,19,1,0
1617,2021-02-25,Los Angeles Clippers,94,Memphis Grizzlies,122,28,1,0
1618,2021-02-25,Washington Wizards,112,Denver Nuggets,110,-2,0,1
1619,2021-02-25,New Orleans Pelicans,125,Milwaukee Bucks,129,4,1,0
1620,2021-02-26,Indiana Pacers,112,Boston Celtics,118,6,1,0
1621,2021-02-26,Houston Rockets,111,Toronto Raptors,122,11,1,0
1622,2021-02-26,Phoenix Suns,106,Chicago Bulls,97,-9,0,1
1623,2021-02-26,Sacramento Kings,110,Detroit Pistons,107,-3,0,1
1624,2021-02-26,Los Angeles Clippers,119,Memphis Grizzlies,99,-20,0,1
1625,2021-02-26,Utah Jazz,116,Miami Heat,124,8,1,0
1626,2021-02-26,Atlanta Hawks,109,Oklahoma City Thunder,118,9,1,0
1627,2021-02-26,Charlotte Hornets,121,Golden State Warriors,130,9,1,0
1628,2021-02-26,Portland Trail Blazers,93,Los Angeles Lakers,102,9,1,0
1629,2021-02-27,Cleveland Cavaliers,112,Philadelphia 76ers,109,-3,0,1
1630,2021-02-27,Minnesota Timberwolves,112,Washington Wizards,128,16,1,0
1631,2021-02-27,Indiana Pacers,107,New York Knicks,110,3,1,0
1632,2021-02-27,Denver Nuggets,126,Oklahoma City Thunder,96,-30,0,1
1633,2021-02-27,Utah Jazz,124,Orlando Magic,109,-15,0,1
1634,2021-02-27,New Orleans Pelicans,114,San Antonio Spurs,117,3,1,0
1635,2021-02-27,Dallas Mavericks,115,Brooklyn Nets,98,-17,0,1
1636,2021-02-28,Los Angeles Clippers,100,Milwaukee Bucks,105,5,1,0
1637,2021-02-28,Washington Wizards,110,Boston Celtics,111,1,1,0
1638,2021-02-28,New York Knicks,109,Detroit Pistons,90,-19,0,1
1639,2021-02-28,Memphis Grizzlies,133,Houston Rockets,84,-49,0,1
1640,2021-02-28,Golden State Warriors,91,Los Angeles Lakers,117,26,1,0
1641,2021-02-28,Atlanta Hawks,99,Miami Heat,109,10,1,0
1642,2021-02-28,Phoenix Suns,118,Minnesota Timberwolves,99,-19,0,1
1643,2021-02-28,Charlotte Hornets,127,Sacramento Kings,126,-1,0,1
1644,2021-03-01,Dallas Mavericks,130,Orlando Magic,124,-6,0,1
1645,2021-03-01,Indiana Pacers,114,Philadelphia 76ers,130,16,1,0
1646,2021-03-01,Denver Nuggets,118,Chicago Bulls,112,-6,0,1
1647,2021-03-01,Utah Jazz,124,New Orleans Pelicans,129,5,1,0
1648,2021-03-01,Brooklyn Nets,124,San Antonio Spurs,113,-11,0,1
1649,2021-03-01,Cleveland Cavaliers,101,Houston Rockets,90,-11,0,1
1650,2021-03-01,Charlotte Hornets,111,Portland Trail Blazers,123,12,1,0
1651,2021-03-02,Memphis Grizzlies,125,Washington Wizards,111,-14,0,1
1652,2021-03-02,Los Angeles Clippers,112,Boston Celtics,117,5,1,0
1653,2021-03-02,Atlanta Hawks,94,Miami Heat,80,-14,0,1
1654,2021-03-02,New York Knicks,93,San Antonio Spurs,119,26,1,0
1655,2021-03-02,Denver Nuggets,128,Milwaukee Bucks,97,-31,0,1
1656,2021-03-02,Phoenix Suns,114,Los Angeles Lakers,104,-10,0,1
1657,2021-03-03,Indiana Pacers,114,Cleveland Cavaliers,111,-3,0,1
1658,2021-03-03,Utah Jazz,123,Philadelphia 76ers,131,8,1,0
1659,2021-03-03,Detroit Pistons,129,Toronto Raptors,105,-24,0,1
1660,2021-03-03,Brooklyn Nets,132,Houston Rockets,114,-18,0,1
1661,2021-03-03,Charlotte Hornets,135,Minnesota Timberwolves,102,-33,0,1
1662,2021-03-03,Chicago Bulls,128,New Orleans Pelicans,124,-4,0,1
1663,2021-03-03,Atlanta Hawks,115,Orlando Magic,112,-3,0,1
1664,2021-03-03,Oklahoma City Thunder,78,Dallas Mavericks,87,9,1,0
1665,2021-03-03,Golden State Warriors,106,Portland Trail Blazers,108,2,1,0
1666,2021-03-03,Los Angeles Lakers,120,Sacramento Kings,123,3,1,0
1667,2021-03-04,Toronto Raptors,125,Boston Celtics,132,7,1,0
1668,2021-03-04,Los Angeles Clippers,117,Washington Wizards,119,2,1,0
1669,2021-03-04,Detroit Pistons,104,New York Knicks,114,10,1,0
1670,2021-03-04,Denver Nuggets,113,Indiana Pacers,103,-10,0,1
1671,2021-03-04,Milwaukee Bucks,112,Memphis Grizzlies,111,-1,0,1
1672,2021-03-04,Miami Heat,103,New Orleans Pelicans,93,-10,0,1
1673,2021-03-04,Oklahoma City Thunder,107,San Antonio Spurs,102,-5,0,1
1674,2021-03-04,Golden State Warriors,98,Phoenix Suns,120,22,1,0
1675,2021-03-04,Sacramento Kings,119,Portland Trail Blazers,123,4,1,0
1676,2021-03-10,Washington Wizards,112,Memphis Grizzlies,127,15,1,0
1677,2021-03-10,San Antonio Spurs,104,Dallas Mavericks,115,11,1,0
1678,2021-03-11,Detroit Pistons,102,Charlotte Hornets,105,3,1,0
1679,2021-03-11,Boston Celtics,109,Brooklyn Nets,121,12,1,0
1680,2021-03-11,Atlanta Hawks,121,Toronto Raptors,120,-1,0,1
1681,2021-03-11,Philadelphia 76ers,127,Chicago Bulls,105,-22,0,1
1682,2021-03-11,Orlando Magic,103,Miami Heat,111,8,1,0
1683,2021-03-11,New York Knicks,101,Milwaukee Bucks,134,33,1,0
1684,2021-03-11,Minnesota Timberwolves,135,New Orleans Pelicans,105,-30,0,1
1685,2021-03-11,Dallas Mavericks,108,Oklahoma City Thunder,116,8,1,0
1686,2021-03-11,Golden State Warriors,104,Los Angeles Clippers,130,26,1,0
1687,2021-03-11,Phoenix Suns,127,Portland Trail Blazers,121,-6,0,1
1688,2021-03-11,Houston Rockets,105,Sacramento Kings,125,20,1,0
1689,2021-03-12,Denver Nuggets,103,Memphis Grizzlies,102,-1,0,1
1690,2021-03-12,Cleveland Cavaliers,82,New Orleans Pelicans,116,34,1,0
1691,2021-03-12,Philadelphia 76ers,127,Washington Wizards,101,-26,0,1
1692,2021-03-12,Miami Heat,101,Chicago Bulls,90,-11,0,1
1693,2021-03-12,Orlando Magic,77,San Antonio Spurs,104,27,1,0
1694,2021-03-12,Houston Rockets,99,Utah Jazz,114,15,1,0
1695,2021-03-12,Indiana Pacers,100,Los Angeles Lakers,105,5,1,0
1696,2021-03-13,New York Knicks,119,Oklahoma City Thunder,97,-22,0,1
1697,2021-03-13,Detroit Pistons,95,Brooklyn Nets,100,5,1,0
1698,2021-03-13,Toronto Raptors,104,Charlotte Hornets,114,10,1,0
1699,2021-03-13,Milwaukee Bucks,125,Washington Wizards,119,-6,0,1
1700,2021-03-13,Sacramento Kings,106,Atlanta Hawks,121,15,1,0
1701,2021-03-13,Portland Trail Blazers,125,Minnesota Timberwolves,121,-4,0,1
1702,2021-03-13,Dallas Mavericks,116,Denver Nuggets,103,-13,0,1
1703,2021-03-13,Indiana Pacers,122,Phoenix Suns,111,-11,0,1
1704,2021-03-14,Memphis Grizzlies,122,Oklahoma City Thunder,128,6,1,0
1705,2021-03-14,Utah Jazz,119,Golden State Warriors,131,12,1,0
1706,2021-03-14,San Antonio Spurs,99,Philadelphia 76ers,134,35,1,0
1707,2021-03-14,Miami Heat,102,Orlando Magic,97,-5,0,1
1708,2021-03-14,Cleveland Cavaliers,82,Atlanta Hawks,100,18,1,0
1709,2021-03-14,Boston Celtics,134,Houston Rockets,107,-27,0,1
1710,2021-03-14,Portland Trail Blazers,112,Minnesota Timberwolves,114,2,1,0
1711,2021-03-14,Toronto Raptors,95,Chicago Bulls,118,23,1,0
1712,2021-03-14,Los Angeles Clippers,115,New Orleans Pelicans,135,20,1,0
1713,2021-03-15,Sacramento Kings,116,Charlotte Hornets,122,6,1,0
1714,2021-03-15,Milwaukee Bucks,133,Washington Wizards,122,-11,0,1
1715,2021-03-15,New York Knicks,112,Brooklyn Nets,117,5,1,0
1716,2021-03-15,San Antonio Spurs,109,Detroit Pistons,99,-10,0,1
1717,2021-03-15,Los Angeles Clippers,109,Dallas Mavericks,99,-10,0,1
1718,2021-03-15,Indiana Pacers,106,Denver Nuggets,121,15,1,0
1719,2021-03-15,Memphis Grizzlies,99,Phoenix Suns,122,23,1,0
1720,2021-03-15,Los Angeles Lakers,128,Golden State Warriors,97,-31,0,1
1721,2021-03-16,Utah Jazz,117,Boston Celtics,109,-8,0,1
1722,2021-03-16,Oklahoma City Thunder,102,Chicago Bulls,123,21,1,0
1723,2021-03-16,Atlanta Hawks,119,Houston Rockets,107,-12,0,1
1724,2021-03-16,Cleveland Cavaliers,98,Miami Heat,113,15,1,0
1725,2021-03-16,New York Knicks,96,Philadelphia 76ers,99,3,1,0
1726,2021-03-16,New Orleans Pelicans,124,Portland Trail Blazers,125,1,1,0
1727,2021-03-16,Minnesota Timberwolves,121,Los Angeles Lakers,137,16,1,0
1728,2021-03-17,Toronto Raptors,112,Detroit Pistons,116,4,1,0
1729,2021-03-17,Brooklyn Nets,124,Indiana Pacers,115,-9,0,1
1730,2021-03-17,Milwaukee Bucks,109,Philadelphia 76ers,105,-4,0,1
1731,2021-03-17,Sacramento Kings,121,Washington Wizards,119,-2,0,1
1732,2021-03-17,San Antonio Spurs,106,Chicago Bulls,99,-7,0,1
1733,2021-03-17,Boston Celtics,110,Cleveland Cavaliers,117,7,1,0
1734,2021-03-17,Golden State Warriors,108,Houston Rockets,94,-14,0,1
1735,2021-03-17,Charlotte Hornets,104,Denver Nuggets,129,25,1,0
1736,2021-03-17,Miami Heat,85,Memphis Grizzlies,89,4,1,0
1737,2021-03-17,Los Angeles Clippers,89,Dallas Mavericks,105,16,1,0
1738,2021-03-18,Utah Jazz,122,Washington Wizards,131,9,1,0
1739,2021-03-18,Oklahoma City Thunder,93,Atlanta Hawks,116,23,1,0
1740,2021-03-18,Orlando Magic,93,New York Knicks,94,1,1,0
1741,2021-03-18,Minnesota Timberwolves,123,Phoenix Suns,119,-4,0,1
1742,2021-03-18,New Orleans Pelicans,93,Portland Trail Blazers,101,8,1,0
1743,2021-03-18,Charlotte Hornets,105,Los Angeles Lakers,116,11,1,0
1744,2021-03-19,Sacramento Kings,107,Boston Celtics,96,-11,0,1
1745,2021-03-19,San Antonio Spurs,116,Cleveland Cavaliers,110,-6,0,1
1746,2021-03-19,Detroit Pistons,113,Houston Rockets,100,-13,0,1
1747,2021-03-19,Golden State Warriors,116,Memphis Grizzlies,103,-13,0,1
1748,2021-03-19,Indiana Pacers,137,Miami Heat,110,-27,0,1
1749,2021-03-19,Brooklyn Nets,113,Orlando Magic,121,8,1,0
1750,2021-03-19,Utah Jazz,115,Toronto Raptors,112,-3,0,1
1751,2021-03-19,Chicago Bulls,127,Denver Nuggets,131,4,1,0
1752,2021-03-19,Minnesota Timberwolves,101,Phoenix Suns,113,12,1,0
1753,2021-03-19,Dallas Mavericks,119,Portland Trail Blazers,125,6,1,0
1754,2021-03-20,Atlanta Hawks,99,Los Angeles Lakers,94,-5,0,1
1755,2021-03-20,Golden State Warriors,103,Memphis Grizzlies,111,8,1,0
1756,2021-03-20,Sacramento Kings,105,Philadelphia 76ers,129,24,1,0
1757,2021-03-20,San Antonio Spurs,113,Milwaukee Bucks,120,7,1,0
1758,2021-03-20,Charlotte Hornets,98,Los Angeles Clippers,125,27,1,0
1759,2021-03-21,Indiana Pacers,109,Miami Heat,106,-3,0,1
1760,2021-03-21,Oklahoma City Thunder,114,Houston Rockets,112,-2,0,1
1761,2021-03-21,New Orleans Pelicans,113,Denver Nuggets,108,-5,0,1
1762,2021-03-21,Orlando Magic,96,Boston Celtics,112,16,1,0
1763,2021-03-21,Washington Wizards,106,Brooklyn Nets,113,7,1,0
1764,2021-03-21,Toronto Raptors,105,Cleveland Cavaliers,116,11,1,0
1765,2021-03-21,Chicago Bulls,100,Detroit Pistons,86,-14,0,1
1766,2021-03-21,Philadelphia 76ers,101,New York Knicks,100,-1,0,1
1767,2021-03-21,Los Angeles Lakers,94,Phoenix Suns,111,17,1,0
1768,2021-03-21,Dallas Mavericks,132,Portland Trail Blazers,92,-40,0,1
1769,2021-03-22,Sacramento Kings,119,Cleveland Cavaliers,105,-14,0,1
1770,2021-03-22,Oklahoma City Thunder,112,Minnesota Timberwolves,103,-9,0,1
1771,2021-03-22,Charlotte Hornets,100,San Antonio Spurs,97,-3,0,1
1772,2021-03-22,Utah Jazz,120,Chicago Bulls,95,-25,0,1
1773,2021-03-22,Toronto Raptors,99,Houston Rockets,117,18,1,0
1774,2021-03-22,Boston Celtics,126,Memphis Grizzlies,132,6,1,0
1775,2021-03-22,Indiana Pacers,113,Milwaukee Bucks,140,27,1,0
1776,2021-03-22,Atlanta Hawks,110,Los Angeles Clippers,119,9,1,0
1777,2021-03-23,Denver Nuggets,110,Orlando Magic,99,-11,0,1
1778,2021-03-23,Los Angeles Lakers,111,New Orleans Pelicans,128,17,1,0
1779,2021-03-23,Washington Wizards,113,New York Knicks,131,18,1,0
1780,2021-03-23,Phoenix Suns,110,Miami Heat,100,-10,0,1
1781,2021-03-23,Philadelphia 76ers,108,Golden State Warriors,98,-10,0,1
1782,2021-03-23,Brooklyn Nets,116,Portland Trail Blazers,112,-4,0,1
1783,2021-03-24,Detroit Pistons,111,Indiana Pacers,116,5,1,0
1784,2021-03-24,Boston Celtics,119,Milwaukee Bucks,121,2,1,0
1785,2021-03-24,Denver Nuggets,111,Toronto Raptors,135,24,1,0
1786,2021-03-24,Cleveland Cavaliers,103,Chicago Bulls,94,-9,0,1
1787,2021-03-24,Charlotte Hornets,122,Houston Rockets,97,-25,0,1
1788,2021-03-24,Dallas Mavericks,128,Minnesota Timberwolves,108,-20,0,1
1789,2021-03-24,Memphis Grizzlies,116,Oklahoma City Thunder,107,-9,0,1
1790,2021-03-24,Phoenix Suns,111,Orlando Magic,112,1,1,0
1791,2021-03-24,Los Angeles Clippers,134,San Antonio Spurs,101,-33,0,1
1792,2021-03-24,Atlanta Hawks,108,Sacramento Kings,110,2,1,0
1793,2021-03-24,Brooklyn Nets,88,Utah Jazz,118,30,1,0
1794,2021-03-25,Portland Trail Blazers,125,Miami Heat,122,-3,0,1
1795,2021-03-25,Washington Wizards,102,New York Knicks,106,4,1,0
1796,2021-03-25,Los Angeles Clippers,98,San Antonio Spurs,85,-13,0,1
1797,2021-03-25,Philadelphia 76ers,109,Los Angeles Lakers,101,-8,0,1
1798,2021-03-25,Golden State Warriors,119,Sacramento Kings,141,22,1,0
1799,2021-03-26,Brooklyn Nets,113,Detroit Pistons,111,-2,0,1
1800,2021-03-26,Boston Celtics,122,Milwaukee Bucks,114,-8,0,1
1801,2021-03-26,Phoenix Suns,104,Toronto Raptors,100,-4,0,1
1802,2021-03-26,Miami Heat,105,Charlotte Hornets,110,5,1,0
1803,2021-03-26,Houston Rockets,101,Minnesota Timberwolves,107,6,1,0
1804,2021-03-26,Denver Nuggets,113,New Orleans Pelicans,108,-5,0,1
1805,2021-03-26,Portland Trail Blazers,112,Orlando Magic,105,-7,0,1
1806,2021-03-26,Indiana Pacers,109,Dallas Mavericks,94,-15,0,1
1807,2021-03-26,Memphis Grizzlies,114,Utah Jazz,117,3,1,0
1808,2021-03-26,Atlanta Hawks,124,Golden State Warriors,108,-16,0,1
1809,2021-03-26,Cleveland Cavaliers,86,Los Angeles Lakers,100,14,1,0
1810,2021-03-27,New York Knicks,102,Milwaukee Bucks,96,-6,0,1
1811,2021-03-27,Houston Rockets,129,Minnesota Timberwolves,107,-22,0,1
1812,2021-03-27,Detroit Pistons,92,Washington Wizards,106,14,1,0
1813,2021-03-27,Chicago Bulls,104,San Antonio Spurs,120,16,1,0
1814,2021-03-27,Dallas Mavericks,103,New Orleans Pelicans,112,9,1,0
1815,2021-03-27,Boston Celtics,111,Oklahoma City Thunder,94,-17,0,1
1816,2021-03-27,Memphis Grizzlies,110,Utah Jazz,126,16,1,0
1817,2021-03-27,Philadelphia 76ers,112,Los Angeles Clippers,122,10,1,0
1818,2021-03-27,Cleveland Cavaliers,98,Sacramento Kings,100,2,1,0
1819,2021-03-28,Phoenix Suns,101,Charlotte Hornets,97,-4,0,1
1820,2021-03-28,Portland Trail Blazers,122,Toronto Raptors,117,-5,0,1
1821,2021-03-28,Atlanta Hawks,102,Denver Nuggets,126,24,1,0
1822,2021-03-28,Orlando Magic,93,Los Angeles Lakers,96,3,1,0
1823,2021-03-29,Indiana Pacers,124,Washington Wizards,132,8,1,0
1824,2021-03-29,New Orleans Pelicans,115,Boston Celtics,109,-6,0,1
1825,2021-03-29,Minnesota Timberwolves,107,Brooklyn Nets,112,5,1,0
1826,2021-03-29,Miami Heat,98,New York Knicks,88,-10,0,1
1827,2021-03-29,Toronto Raptors,104,Detroit Pistons,118,14,1,0
1828,2021-03-29,Memphis Grizzlies,120,Houston Rockets,110,-10,0,1
1829,2021-03-29,Dallas Mavericks,127,Oklahoma City Thunder,106,-21,0,1
1830,2021-03-29,Sacramento Kings,132,San Antonio Spurs,115,-17,0,1
1831,2021-03-29,Cleveland Cavaliers,75,Utah Jazz,114,39,1,0
1832,2021-03-29,Chicago Bulls,102,Golden State Warriors,116,14,1,0
1833,2021-03-29,Milwaukee Bucks,105,Los Angeles Clippers,129,24,1,0
1834,2021-03-30,Charlotte Hornets,114,Washington Wizards,104,-10,0,1
1835,2021-03-30,Philadelphia 76ers,95,Denver Nuggets,104,9,1,0
1836,2021-03-30,Orlando Magic,103,Los Angeles Clippers,96,-7,0,1
1837,2021-03-30,Atlanta Hawks,110,Phoenix Suns,117,7,1,0
1838,2021-03-31,Portland Trail Blazers,124,Detroit Pistons,101,-23,0,1
1839,2021-03-31,Miami Heat,92,Indiana Pacers,87,-5,0,1
1840,2021-03-31,Dallas Mavericks,113,Boston Celtics,108,-5,0,1
1841,2021-03-31,Houston Rockets,108,Brooklyn Nets,120,12,1,0
1842,2021-03-31,Utah Jazz,111,Memphis Grizzlies,107,-4,0,1
1843,2021-03-31,New York Knicks,101,Minnesota Timberwolves,102,1,1,0
1844,2021-03-31,Toronto Raptors,103,Oklahoma City Thunder,113,10,1,0
1845,2021-03-31,Sacramento Kings,106,San Antonio Spurs,120,14,1,0
1846,2021-03-31,Milwaukee Bucks,112,Los Angeles Lakers,97,-15,0,1
1847,2021-03-31,Chicago Bulls,116,Phoenix Suns,121,5,1,0
1848,2021-04-01,Philadelphia 76ers,114,Cleveland Cavaliers,94,-20,0,1
1849,2021-04-01,Washington Wizards,91,Detroit Pistons,120,29,1,0
1850,2021-04-01,Charlotte Hornets,89,Brooklyn Nets,111,22,1,0
1851,2021-04-01,Golden State Warriors,109,Miami Heat,116,7,1,0
1852,2021-04-01,Orlando Magic,115,New Orleans Pelicans,110,-5,0,1
1853,2021-04-01,Atlanta Hawks,134,San Antonio Spurs,129,-5,0,1
1854,2021-04-01,Denver Nuggets,101,Los Angeles Clippers,94,-7,0,1
1855,2021-04-02,Golden State Warriors,77,Toronto Raptors,130,53,1,0
1856,2021-04-02,Houston Rockets,102,Boston Celtics,118,16,1,0
1857,2021-04-02,Dallas Mavericks,99,New York Knicks,86,-13,0,1
1858,2021-04-02,Charlotte Hornets,114,Indiana Pacers,97,-17,0,1
1859,2021-04-02,Minnesota Timberwolves,108,Memphis Grizzlies,120,12,1,0
1860,2021-04-02,Atlanta Hawks,126,New Orleans Pelicans,103,-23,0,1
1861,2021-04-02,Chicago Bulls,106,Utah Jazz,113,7,1,0
1862,2021-04-02,Oklahoma City Thunder,103,Phoenix Suns,140,37,1,0
1863,2021-04-02,Milwaukee Bucks,127,Portland Trail Blazers,109,-18,0,1
1864,2021-04-02,Los Angeles Lakers,115,Sacramento Kings,94,-21,0,1
1865,2021-04-03,Dallas Mavericks,109,Washington Wizards,87,-22,0,1
1866,2021-04-03,New York Knicks,125,Detroit Pistons,81,-44,0,1
1867,2021-04-03,Cleveland Cavaliers,101,Miami Heat,115,14,1,0
1868,2021-04-03,Minnesota Timberwolves,113,Philadelphia 76ers,122,9,1,0
1869,2021-04-03,Indiana Pacers,139,San Antonio Spurs,133,-6,0,1
1870,2021-04-03,Orlando Magic,91,Utah Jazz,137,46,1,0
1871,2021-04-03,Oklahoma City Thunder,85,Portland Trail Blazers,133,48,1,0
1872,2021-04-03,Milwaukee Bucks,129,Sacramento Kings,128,-1,0,1
1873,2021-04-04,Brooklyn Nets,107,Chicago Bulls,115,8,1,0
1874,2021-04-04,Los Angeles Lakers,86,Los Angeles Clippers,104,18,1,0
1875,2021-04-04,Charlotte Hornets,86,Boston Celtics,116,30,1,0
1876,2021-04-04,Memphis Grizzlies,116,Philadelphia 76ers,100,-16,0,1
1877,2021-04-04,Golden State Warriors,111,Atlanta Hawks,117,6,1,0
1878,2021-04-04,New Orleans Pelicans,122,Houston Rockets,115,-7,0,1
1879,2021-04-04,Orlando Magic,109,Denver Nuggets,119,10,1,0
1880,2021-04-05,New York Knicks,112,Brooklyn Nets,114,2,1,0
1881,2021-04-05,Utah Jazz,103,Dallas Mavericks,111,8,1,0
1882,2021-04-05,Sacramento Kings,106,Minnesota Timberwolves,116,10,1,0
1883,2021-04-05,Detroit Pistons,132,Oklahoma City Thunder,108,-24,0,1
1884,2021-04-05,Cleveland Cavaliers,125,San Antonio Spurs,101,-24,0,1
1885,2021-04-05,Washington Wizards,101,Toronto Raptors,103,2,1,0
1886,2021-04-05,Phoenix Suns,133,Houston Rockets,130,-3,0,1
1887,2021-04-06,Chicago Bulls,113,Indiana Pacers,97,-16,0,1
1888,2021-04-06,New Orleans Pelicans,107,Atlanta Hawks,123,16,1,0
1889,2021-04-06,Philadelphia 76ers,106,Boston Celtics,96,-10,0,1
1890,2021-04-06,Los Angeles Lakers,110,Toronto Raptors,101,-9,0,1
1891,2021-04-06,Memphis Grizzlies,124,Miami Heat,112,-12,0,1
1892,2021-04-06,Detroit Pistons,119,Denver Nuggets,134,15,1,0
1893,2021-04-06,Milwaukee Bucks,121,Golden State Warriors,122,1,1,0
1894,2021-04-06,Portland Trail Blazers,116,Los Angeles Clippers,133,17,1,0
1895,2021-04-07,Minnesota Timberwolves,137,Indiana Pacers,141,4,1,0
1896,2021-04-07,Washington Wizards,131,Orlando Magic,116,-15,0,1
1897,2021-04-07,New York Knicks,99,Boston Celtics,101,2,1,0
1898,2021-04-07,New Orleans Pelicans,111,Brooklyn Nets,139,28,1,0
1899,2021-04-07,Memphis Grizzlies,131,Atlanta Hawks,113,-18,0,1
1900,2021-04-07,Dallas Mavericks,93,Houston Rockets,102,9,1,0
1901,2021-04-07,Charlotte Hornets,113,Oklahoma City Thunder,102,-11,0,1
1902,2021-04-07,San Antonio Spurs,96,Denver Nuggets,106,10,1,0
1903,2021-04-07,Utah Jazz,113,Phoenix Suns,117,4,1,0
1904,2021-04-08,Los Angeles Lakers,104,Miami Heat,110,6,1,0
1905,2021-04-08,Chicago Bulls,122,Toronto Raptors,113,-9,0,1
1906,2021-04-08,Cleveland Cavaliers,129,Oklahoma City Thunder,102,-27,0,1
1907,2021-04-08,Milwaukee Bucks,101,Dallas Mavericks,116,15,1,0
1908,2021-04-08,Phoenix Suns,103,Los Angeles Clippers,113,10,1,0
1909,2021-04-08,Detroit Pistons,113,Sacramento Kings,101,-12,0,1
1910,2021-04-08,Portland Trail Blazers,103,Utah Jazz,122,19,1,0
1911,2021-04-09,Indiana Pacers,111,Orlando Magic,106,-5,0,1
1912,2021-04-09,Minnesota Timberwolves,136,Boston Celtics,145,9,1,0
1913,2021-04-09,Memphis Grizzlies,129,New York Knicks,133,4,1,0
1914,2021-04-09,Chicago Bulls,108,Atlanta Hawks,120,12,1,0
1915,2021-04-09,Philadelphia 76ers,94,New Orleans Pelicans,101,7,1,0
1916,2021-04-09,San Antonio Spurs,119,Denver Nuggets,121,2,1,0
1917,2021-04-09,Charlotte Hornets,127,Milwaukee Bucks,119,-8,0,1
1918,2021-04-09,Washington Wizards,110,Golden State Warriors,107,-3,0,1
1919,2021-04-09,Houston Rockets,109,Los Angeles Clippers,126,17,1,0
1920,2021-04-10,Toronto Raptors,135,Cleveland Cavaliers,115,-20,0,1
1921,2021-04-10,Los Angeles Lakers,126,Brooklyn Nets,101,-25,0,1
1922,2021-04-10,Philadelphia 76ers,117,Oklahoma City Thunder,93,-24,0,1
1923,2021-04-10,Sacramento Kings,112,Utah Jazz,128,16,1,0
1924,2021-04-10,Houston Rockets,109,Golden State Warriors,125,16,1,0
1925,2021-04-10,Washington Wizards,106,Phoenix Suns,134,28,1,0
1926,2021-04-10,Detroit Pistons,103,Portland Trail Blazers,118,15,1,0
1927,2021-04-11,Atlanta Hawks,105,Charlotte Hornets,101,-4,0,1
1928,2021-04-11,Boston Celtics,105,Denver Nuggets,87,-18,0,1
1929,2021-04-11,New Orleans Pelicans,116,Cleveland Cavaliers,109,-7,0,1
1930,2021-04-11,Milwaukee Bucks,124,Orlando Magic,87,-37,0,1
1931,2021-04-11,San Antonio Spurs,119,Dallas Mavericks,117,-2,0,1
1932,2021-04-11,Indiana Pacers,132,Memphis Grizzlies,125,-7,0,1
1933,2021-04-11,Chicago Bulls,117,Minnesota Timberwolves,121,4,1,0
1934,2021-04-11,Toronto Raptors,96,New York Knicks,102,6,1,0
1935,2021-04-11,Detroit Pistons,124,Los Angeles Clippers,131,7,1,0
1936,2021-04-11,Miami Heat,107,Portland Trail Blazers,98,-9,0,1
1937,2021-04-12,Philadelphia 76ers,113,Dallas Mavericks,95,-18,0,1
1938,2021-04-12,Los Angeles Lakers,96,New York Knicks,111,15,1,0
1939,2021-04-12,San Antonio Spurs,120,Orlando Magic,97,-23,0,1
1940,2021-04-12,Chicago Bulls,90,Memphis Grizzlies,101,11,1,0
1941,2021-04-12,Sacramento Kings,110,New Orleans Pelicans,117,7,1,0
1942,2021-04-12,Washington Wizards,125,Utah Jazz,121,-4,0,1
1943,2021-04-12,Denver Nuggets,107,Golden State Warriors,116,9,1,0
1944,2021-04-12,Houston Rockets,120,Phoenix Suns,126,6,1,0
1945,2021-04-13,Brooklyn Nets,127,Minnesota Timberwolves,97,-30,0,1
1946,2021-04-13,Los Angeles Clippers,126,Indiana Pacers,115,-11,0,1
1947,2021-04-13,Atlanta Hawks,108,Toronto Raptors,103,-5,0,1
1948,2021-04-13,Los Angeles Lakers,101,Charlotte Hornets,93,-8,0,1
1949,2021-04-13,Oklahoma City Thunder,96,Utah Jazz,106,10,1,0
1950,2021-04-13,Miami Heat,86,Phoenix Suns,106,20,1,0
1951,2021-04-13,Boston Celtics,116,Portland Trail Blazers,115,-1,0,1
1952,2021-04-14,Milwaukee Bucks,130,Minnesota Timberwolves,105,-25,0,1
1953,2021-04-14,Cleveland Cavaliers,103,Charlotte Hornets,90,-13,0,1
1954,2021-04-14,Brooklyn Nets,117,Philadelphia 76ers,123,6,1,0
1955,2021-04-14,San Antonio Spurs,112,Toronto Raptors,117,5,1,0
1956,2021-04-14,Orlando Magic,115,Chicago Bulls,106,-9,0,1
1957,2021-04-14,Los Angeles Clippers,100,Detroit Pistons,98,-2,0,1
1958,2021-04-14,New York Knicks,116,New Orleans Pelicans,106,-10,0,1
1959,2021-04-14,Indiana Pacers,132,Houston Rockets,124,-8,0,1
1960,2021-04-14,Golden State Warriors,147,Oklahoma City Thunder,109,-38,0,1
1961,2021-04-14,Dallas Mavericks,114,Memphis Grizzlies,113,-1,0,1
1962,2021-04-14,Miami Heat,106,Denver Nuggets,123,17,1,0
1963,2021-04-14,Washington Wizards,123,Sacramento Kings,111,-12,0,1
1964,2021-04-15,Milwaukee Bucks,120,Atlanta Hawks,109,-11,0,1
1965,2021-04-15,Golden State Warriors,119,Cleveland Cavaliers,101,-18,0,1
1966,2021-04-15,Boston Celtics,121,Los Angeles Lakers,113,-8,0,1
1967,2021-04-15,Sacramento Kings,114,Phoenix Suns,122,8,1,0
1968,2021-04-16,Indiana Pacers,111,Utah Jazz,119,8,1,0
1969,2021-04-16,Oklahoma City Thunder,104,Detroit Pistons,110,6,1,0
1970,2021-04-16,Los Angeles Clippers,103,Philadelphia 76ers,106,3,1,0
1971,2021-04-16,New Orleans Pelicans,115,Washington Wizards,117,2,1,0
1972,2021-04-16,Charlotte Hornets,115,Brooklyn Nets,130,15,1,0
1973,2021-04-16,Orlando Magic,102,Toronto Raptors,113,11,1,0
1974,2021-04-16,Memphis Grizzlies,126,Chicago Bulls,115,-11,0,1
1975,2021-04-16,Denver Nuggets,128,Houston Rockets,99,-29,0,1
1976,2021-04-16,Miami Heat,111,Minnesota Timberwolves,119,8,1,0
1977,2021-04-16,Portland Trail Blazers,107,San Antonio Spurs,106,-1,0,1
1978,2021-04-16,New York Knicks,117,Dallas Mavericks,109,-8,0,1
1979,2021-04-17,Utah Jazz,115,Los Angeles Lakers,127,12,1,0
1980,2021-04-17,Cleveland Cavaliers,96,Chicago Bulls,106,10,1,0
1981,2021-04-17,Detroit Pistons,100,Washington Wizards,121,21,1,0
1982,2021-04-17,Golden State Warriors,114,Boston Celtics,119,5,1,0
1983,2021-04-17,Memphis Grizzlies,128,Milwaukee Bucks,115,-13,0,1
1984,2021-04-17,San Antonio Spurs,111,Phoenix Suns,85,-26,0,1
1985,2021-04-18,Indiana Pacers,117,Atlanta Hawks,129,12,1,0
1986,2021-04-18,New Orleans Pelicans,112,New York Knicks,122,10,1,0
1987,2021-04-18,Brooklyn Nets,107,Miami Heat,109,2,1,0
1988,2021-04-18,Portland Trail Blazers,101,Charlotte Hornets,109,8,1,0
1989,2021-04-18,Houston Rockets,114,Orlando Magic,110,-4,0,1
1990,2021-04-18,Oklahoma City Thunder,106,Toronto Raptors,112,6,1,0
1991,2021-04-18,Sacramento Kings,121,Dallas Mavericks,107,-14,0,1
1992,2021-04-18,Minnesota Timberwolves,105,Los Angeles Clippers,124,19,1,0
1993,2021-04-19,Cleveland Cavaliers,105,Detroit Pistons,109,4,1,0
1994,2021-04-19,Chicago Bulls,102,Boston Celtics,96,-6,0,1
1995,2021-04-19,Golden State Warriors,107,Philadelphia 76ers,96,-11,0,1
1996,2021-04-19,San Antonio Spurs,109,Indiana Pacers,94,-15,0,1
1997,2021-04-19,Houston Rockets,91,Miami Heat,113,22,1,0
1998,2021-04-19,Phoenix Suns,128,Milwaukee Bucks,127,-1,0,1
1999,2021-04-19,Oklahoma City Thunder,107,Washington Wizards,119,12,1,0
2000,2021-04-19,Memphis Grizzlies,137,Denver Nuggets,139,2,1,0
2001,2021-04-19,Utah Jazz,111,Los Angeles Lakers,97,-14,0,1
2002,2021-04-20,Orlando Magic,96,Atlanta Hawks,112,16,1,0
2003,2021-04-20,Brooklyn Nets,134,New Orleans Pelicans,129,-5,0,1
2004,2021-04-20,Charlotte Hornets,97,New York Knicks,109,12,1,0
2005,2021-04-20,Los Angeles Clippers,113,Portland Trail Blazers,112,-1,0,1
2006,2021-04-20,Minnesota Timberwolves,134,Sacramento Kings,120,-14,0,1
2007,2021-04-21,Chicago Bulls,105,Cleveland Cavaliers,121,16,1,0
2008,2021-04-21,Oklahoma City Thunder,116,Indiana Pacers,122,6,1,0
2009,2021-04-21,Phoenix Suns,116,Philadelphia 76ers,113,-3,0,1
2010,2021-04-21,Brooklyn Nets,103,Toronto Raptors,114,11,1,0
2011,2021-04-21,Golden State Warriors,114,Washington Wizards,118,4,1,0
2012,2021-04-21,Utah Jazz,112,Houston Rockets,89,-23,0,1
2013,2021-04-21,Atlanta Hawks,127,New York Knicks,137,10,1,0
2014,2021-04-21,Detroit Pistons,117,Dallas Mavericks,127,10,1,0
2015,2021-04-21,Miami Heat,107,San Antonio Spurs,87,-20,0,1
2016,2021-04-21,Memphis Grizzlies,105,Los Angeles Clippers,117,12,1,0
2017,2021-04-21,Denver Nuggets,106,Portland Trail Blazers,105,-1,0,1
2018,2021-04-21,Minnesota Timberwolves,125,Sacramento Kings,128,3,1,0
2019,2021-04-22,Phoenix Suns,86,Boston Celtics,99,13,1,0
2020,2021-04-22,Philadelphia 76ers,117,Milwaukee Bucks,124,7,1,0
2021,2021-04-22,New Orleans Pelicans,135,Orlando Magic,100,-35,0,1
2022,2021-04-22,Detroit Pistons,91,San Antonio Spurs,106,15,1,0
2023,2021-04-22,Charlotte Hornets,91,Chicago Bulls,108,17,1,0
2024,2021-04-22,Los Angeles Lakers,110,Dallas Mavericks,115,5,1,0
2025,2021-04-23,Miami Heat,103,Atlanta Hawks,118,15,1,0
2026,2021-04-23,Boston Celtics,104,Brooklyn Nets,109,5,1,0
2027,2021-04-23,Cleveland Cavaliers,102,Charlotte Hornets,108,6,1,0
2028,2021-04-23,Los Angeles Clippers,109,Houston Rockets,104,-5,0,1
2029,2021-04-23,Washington Wizards,129,Oklahoma City Thunder,109,-20,0,1
2030,2021-04-23,Denver Nuggets,97,Golden State Warriors,118,21,1,0
2031,2021-04-23,Memphis Grizzlies,130,Portland Trail Blazers,128,-2,0,1
2032,2021-04-24,Toronto Raptors,103,New York Knicks,120,17,1,0
2033,2021-04-24,Philadelphia 76ers,94,Milwaukee Bucks,132,38,1,0
2034,2021-04-24,Detroit Pistons,109,Indiana Pacers,115,6,1,0
2035,2021-04-24,Chicago Bulls,101,Miami Heat,106,5,1,0
2036,2021-04-24,San Antonio Spurs,110,New Orleans Pelicans,108,-2,0,1
2037,2021-04-24,Los Angeles Lakers,93,Dallas Mavericks,108,15,1,0
2038,2021-04-24,Minnesota Timberwolves,101,Utah Jazz,96,-5,0,1
2039,2021-04-24,Houston Rockets,116,Denver Nuggets,129,13,1,0
2040,2021-04-25,Boston Celtics,104,Charlotte Hornets,125,21,1,0
2041,2021-04-25,Phoenix Suns,119,Brooklyn Nets,128,9,1,0
2042,2021-04-25,Memphis Grizzlies,120,Portland Trail Blazers,113,-7,0,1
2043,2021-04-25,Cleveland Cavaliers,110,Washington Wizards,119,9,1,0
2044,2021-04-25,Milwaukee Bucks,104,Atlanta Hawks,111,7,1,0
2045,2021-04-25,Indiana Pacers,131,Orlando Magic,112,-19,0,1
2046,2021-04-25,Sacramento Kings,113,Golden State Warriors,117,4,1,0
2047,2021-04-26,Atlanta Hawks,86,Detroit Pistons,100,14,1,0
2048,2021-04-26,Los Angeles Lakers,114,Orlando Magic,103,-11,0,1
2049,2021-04-26,Oklahoma City Thunder,90,Philadelphia 76ers,121,31,1,0
2050,2021-04-26,San Antonio Spurs,146,Washington Wizards,143,-3,0,1
2051,2021-04-26,Phoenix Suns,118,New York Knicks,110,-8,0,1
2052,2021-04-26,Cleveland Cavaliers,96,Toronto Raptors,112,16,1,0
2053,2021-04-26,Chicago Bulls,110,Miami Heat,102,-8,0,1
2054,2021-04-26,Utah Jazz,104,Minnesota Timberwolves,105,1,1,0
2055,2021-04-26,Los Angeles Clippers,103,New Orleans Pelicans,120,17,1,0
2056,2021-04-26,Memphis Grizzlies,96,Denver Nuggets,120,24,1,0
2057,2021-04-26,Dallas Mavericks,106,Sacramento Kings,113,7,1,0
2058,2021-04-27,Oklahoma City Thunder,119,Boston Celtics,115,-4,0,1
2059,2021-04-27,Milwaukee Bucks,114,Charlotte Hornets,104,-10,0,1
2060,2021-04-27,Portland Trail Blazers,133,Indiana Pacers,112,-21,0,1
2061,2021-04-27,Brooklyn Nets,116,Toronto Raptors,103,-13,0,1
2062,2021-04-27,Minnesota Timberwolves,114,Houston Rockets,107,-7,0,1
2063,2021-04-27,Dallas Mavericks,133,Golden State Warriors,103,-30,0,1
2064,2021-04-28,Orlando Magic,109,Cleveland Cavaliers,104,-5,0,1
2065,2021-04-28,Atlanta Hawks,83,Philadelphia 76ers,127,44,1,0
2066,2021-04-28,Charlotte Hornets,111,Boston Celtics,120,9,1,0
2067,2021-04-28,Chicago Bulls,94,New York Knicks,113,19,1,0
2068,2021-04-28,Los Angeles Lakers,107,Washington Wizards,116,9,1,0
2069,2021-04-28,San Antonio Spurs,111,Miami Heat,116,5,1,0
2070,2021-04-28,New Orleans Pelicans,112,Denver Nuggets,114,2,1,0
2071,2021-04-28,Portland Trail Blazers,130,Memphis Grizzlies,109,-21,0,1
2072,2021-04-28,Los Angeles Clippers,101,Phoenix Suns,109,8,1,0
2073,2021-04-28,Utah Jazz,154,Sacramento Kings,105,-49,0,1
2074,2021-04-29,Dallas Mavericks,115,Detroit Pistons,105,-10,0,1
2075,2021-04-29,Brooklyn Nets,130,Indiana Pacers,113,-17,0,1
2076,2021-04-29,Milwaukee Bucks,136,Houston Rockets,143,7,1,0
2077,2021-04-29,Golden State Warriors,114,Minnesota Timberwolves,126,12,1,0
2078,2021-04-29,Toronto Raptors,111,Denver Nuggets,121,10,1,0
2079,2021-04-29,New Orleans Pelicans,109,Oklahoma City Thunder,95,-14,0,1
2080,2021-04-30,Atlanta Hawks,104,Philadelphia 76ers,126,22,1,0
2081,2021-04-30,San Antonio Spurs,140,Boston Celtics,143,3,1,0
2082,2021-04-30,Washington Wizards,122,Cleveland Cavaliers,93,-29,0,1
2083,2021-04-30,Portland Trail Blazers,128,Brooklyn Nets,109,-19,0,1
2084,2021-04-30,Orlando Magic,75,Memphis Grizzlies,92,17,1,0
2085,2021-04-30,Milwaukee Bucks,108,Chicago Bulls,98,-10,0,1
2086,2021-04-30,Utah Jazz,100,Phoenix Suns,121,21,1,0
2087,2021-04-30,Sacramento Kings,110,Los Angeles Lakers,106,-4,0,1
2088,2021-05-01,Detroit Pistons,94,Charlotte Hornets,107,13,1,0
2089,2021-05-01,Golden State Warriors,113,Houston Rockets,87,-26,0,1
2090,2021-05-01,Chicago Bulls,97,Atlanta Hawks,108,11,1,0
2091,2021-05-01,Miami Heat,124,Cleveland Cavaliers,107,-17,0,1
2092,2021-05-01,New Orleans Pelicans,140,Minnesota Timberwolves,136,-4,0,1
2093,2021-05-01,Indiana Pacers,152,Oklahoma City Thunder,95,-57,0,1
2094,2021-05-01,Memphis Grizzlies,111,Orlando Magic,112,1,1,0
2095,2021-05-01,Washington Wizards,124,Dallas Mavericks,125,1,1,0
2096,2021-05-01,Denver Nuggets,110,Los Angeles Clippers,104,-6,0,1
2097,2021-05-01,Toronto Raptors,102,Utah Jazz,106,4,1,0
2098,2021-05-02,Brooklyn Nets,114,Milwaukee Bucks,117,3,1,0
2099,2021-05-02,Portland Trail Blazers,129,Boston Celtics,119,-10,0,1
2100,2021-05-02,Miami Heat,121,Charlotte Hornets,111,-10,0,1
2101,2021-05-02,Sacramento Kings,111,Dallas Mavericks,99,-12,0,1
2102,2021-05-02,New York Knicks,122,Houston Rockets,97,-25,0,1
2103,2021-05-02,Phoenix Suns,123,Oklahoma City Thunder,120,-3,0,1
2104,2021-05-02,Philadelphia 76ers,113,San Antonio Spurs,111,-2,0,1
2105,2021-05-02,Toronto Raptors,121,Los Angeles Lakers,114,-7,0,1
2106,2021-05-03,Orlando Magic,119,Detroit Pistons,112,-7,0,1
2107,2021-05-03,Indiana Pacers,141,Washington Wizards,154,13,1,0
2108,2021-05-03,Golden State Warriors,123,New Orleans Pelicans,108,-15,0,1
2109,2021-05-03,Portland Trail Blazers,114,Atlanta Hawks,123,9,1,0
2110,2021-05-03,Philadelphia 76ers,106,Chicago Bulls,94,-12,0,1
2111,2021-05-03,New York Knicks,118,Memphis Grizzlies,104,-14,0,1
2112,2021-05-03,Denver Nuggets,89,Los Angeles Lakers,93,4,1,0
2113,2021-05-03,San Antonio Spurs,99,Utah Jazz,110,11,1,0
2114,2021-05-04,Phoenix Suns,134,Cleveland Cavaliers,118,-16,0,1
2115,2021-05-04,Charlotte Hornets,102,Detroit Pistons,99,-3,0,1
2116,2021-05-04,Brooklyn Nets,118,Milwaukee Bucks,124,6,1,0
2117,2021-05-04,Dallas Mavericks,127,Miami Heat,113,-14,0,1
2118,2021-05-04,Golden State Warriors,103,New Orleans Pelicans,108,5,1,0
2119,2021-05-04,Sacramento Kings,103,Oklahoma City Thunder,99,-4,0,1
2120,2021-05-04,Toronto Raptors,100,Los Angeles Clippers,105,5,1,0
2121,2021-05-05,Boston Celtics,132,Orlando Magic,96,-36,0,1
2122,2021-05-05,Portland Trail Blazers,141,Cleveland Cavaliers,105,-36,0,1
2123,2021-05-05,Phoenix Suns,103,Atlanta Hawks,135,32,1,0
2124,2021-05-05,Philadelphia 76ers,135,Houston Rockets,115,-20,0,1
2125,2021-05-05,Sacramento Kings,104,Indiana Pacers,93,-11,0,1
2126,2021-05-05,Washington Wizards,134,Milwaukee Bucks,135,1,1,0
2127,2021-05-05,Memphis Grizzlies,139,Minnesota Timberwolves,135,-4,0,1
2128,2021-05-05,New York Knicks,97,Denver Nuggets,113,16,1,0
2129,2021-05-05,San Antonio Spurs,94,Utah Jazz,126,32,1,0
2130,2021-05-06,Chicago Bulls,120,Charlotte Hornets,99,-21,0,1
2131,2021-05-06,Brooklyn Nets,109,Dallas Mavericks,113,4,1,0
2132,2021-05-06,Washington Wizards,131,Toronto Raptors,129,-2,0,1
2133,2021-05-06,Memphis Grizzlies,97,Detroit Pistons,111,14,1,0
2134,2021-05-06,Atlanta Hawks,126,Indiana Pacers,133,7,1,0
2135,2021-05-06,Oklahoma City Thunder,97,Golden State Warriors,118,21,1,0
2136,2021-05-06,Los Angeles Lakers,94,Los Angeles Clippers,118,24,1,0
2137,2021-05-07,New Orleans Pelicans,107,Philadelphia 76ers,109,2,1,0
2138,2021-05-07,Boston Celtics,99,Chicago Bulls,121,22,1,0
2139,2021-05-07,Orlando Magic,112,Charlotte Hornets,122,10,1,0
2140,2021-05-07,Minnesota Timberwolves,112,Miami Heat,121,9,1,0
2141,2021-05-07,Houston Rockets,133,Milwaukee Bucks,141,8,1,0
2142,2021-05-07,Cleveland Cavaliers,90,Dallas Mavericks,110,20,1,0
2143,2021-05-07,Denver Nuggets,120,Utah Jazz,127,7,1,0
2144,2021-05-07,New York Knicks,105,Phoenix Suns,128,23,1,0
2145,2021-05-07,Los Angeles Lakers,101,Portland Trail Blazers,106,5,1,0
2146,2021-05-07,San Antonio Spurs,113,Sacramento Kings,104,-9,0,1
2147,2021-05-08,Washington Wizards,133,Indiana Pacers,132,-1,0,1
2148,2021-05-08,Detroit Pistons,104,Philadelphia 76ers,118,14,1,0
2149,2021-05-08,Memphis Grizzlies,109,Toronto Raptors,99,-10,0,1
2150,2021-05-08,Brooklyn Nets,125,Denver Nuggets,119,-6,0,1
2151,2021-05-08,Oklahoma City Thunder,97,Golden State Warriors,136,39,1,0
2152,2021-05-08,San Antonio Spurs,102,Portland Trail Blazers,124,22,1,0
2153,2021-05-08,Houston Rockets,116,Utah Jazz,124,8,1,0
2154,2021-05-09,Miami Heat,130,Boston Celtics,124,-6,0,1
2155,2021-05-09,New York Knicks,106,Los Angeles Clippers,100,-6,0,1
2156,2021-05-09,New Orleans Pelicans,112,Charlotte Hornets,110,-2,0,1
2157,2021-05-09,Dallas Mavericks,124,Cleveland Cavaliers,97,-27,0,1
2158,2021-05-09,Minnesota Timberwolves,128,Orlando Magic,96,-32,0,1
2159,2021-05-09,Chicago Bulls,108,Detroit Pistons,96,-12,0,1
2160,2021-05-09,Phoenix Suns,110,Los Angeles Lakers,123,13,1,0
2161,2021-05-09,Oklahoma City Thunder,98,Sacramento Kings,126,28,1,0
2162,2021-05-10,Washington Wizards,124,Atlanta Hawks,125,1,1,0
2163,2021-05-10,Indiana Pacers,111,Cleveland Cavaliers,102,-9,0,1
2164,2021-05-10,New Orleans Pelicans,110,Memphis Grizzlies,115,5,1,0
2165,2021-05-10,Milwaukee Bucks,125,San Antonio Spurs,146,21,1,0
2166,2021-05-10,Utah Jazz,116,Golden State Warriors,119,3,1,0
2167,2021-05-10,Houston Rockets,129,Portland Trail Blazers,140,11,1,0
2168,2021-05-11,Denver Nuggets,117,Charlotte Hornets,112,-5,0,1
2169,2021-05-11,Minnesota Timberwolves,119,Detroit Pistons,100,-19,0,1
2170,2021-05-11,Miami Heat,129,Boston Celtics,121,-8,0,1
2171,2021-05-11,Los Angeles Clippers,115,Toronto Raptors,96,-19,0,1
2172,2021-05-11,Brooklyn Nets,115,Chicago Bulls,107,-8,0,1
2173,2021-05-11,Philadelphia 76ers,94,Indiana Pacers,103,9,1,0
2174,2021-05-11,Dallas Mavericks,104,Memphis Grizzlies,133,29,1,0
2175,2021-05-11,Orlando Magic,102,Milwaukee Bucks,114,12,1,0
2176,2021-05-11,Phoenix Suns,116,Golden State Warriors,122,6,1,0
2177,2021-05-11,New York Knicks,99,Los Angeles Lakers,101,2,1,0
2178,2021-05-11,Oklahoma City Thunder,106,Sacramento Kings,122,16,1,0
2179,2021-05-12,Washington Wizards,116,Atlanta Hawks,120,4,1,0
2180,2021-05-12,San Antonio Spurs,116,Brooklyn Nets,128,12,1,0
2181,2021-05-12,Boston Celtics,94,Cleveland Cavaliers,102,8,1,0
2182,2021-05-12,New Orleans Pelicans,107,Dallas Mavericks,125,18,1,0
2183,2021-05-12,Portland Trail Blazers,105,Utah Jazz,98,-7,0,1
2184,2021-05-12,Houston Rockets,122,Los Angeles Lakers,124,2,1,0
2185,2021-05-13,Los Angeles Clippers,113,Charlotte Hornets,90,-23,0,1
2186,2021-05-13,Milwaukee Bucks,142,Indiana Pacers,133,-9,0,1
2187,2021-05-13,Orlando Magic,93,Atlanta Hawks,116,23,1,0
2188,2021-05-13,Philadelphia 76ers,94,Miami Heat,106,12,1,0
2189,2021-05-13,San Antonio Spurs,98,New York Knicks,102,4,1,0
2190,2021-05-13,Toronto Raptors,102,Chicago Bulls,114,12,1,0
2191,2021-05-13,Sacramento Kings,110,Memphis Grizzlies,116,6,1,0
2192,2021-05-13,Denver Nuggets,114,Minnesota Timberwolves,103,-11,0,1
2193,2021-05-13,Portland Trail Blazers,117,Phoenix Suns,118,1,1,0
2194,2021-05-14,Cleveland Cavaliers,105,Washington Wizards,120,15,1,0
2195,2021-05-14,Denver Nuggets,104,Detroit Pistons,91,-13,0,1
2196,2021-05-14,Utah Jazz,109,Oklahoma City Thunder,93,-16,0,1
2197,2021-05-14,Orlando Magic,97,Philadelphia 76ers,122,25,1,0
2198,2021-05-14,Toronto Raptors,110,Dallas Mavericks,114,4,1,0
2199,2021-05-14,Los Angeles Clippers,115,Houston Rockets,122,7,1,0
2200,2021-05-14,Sacramento Kings,106,Memphis Grizzlies,107,1,1,0
2201,2021-05-14,New Orleans Pelicans,122,Golden State Warriors,125,3,1,0
2202,2021-05-15,Chicago Bulls,91,Brooklyn Nets,105,14,1,0
2203,2021-05-15,Los Angeles Lakers,122,Indiana Pacers,115,-7,0,1
2204,2021-05-15,Charlotte Hornets,109,New York Knicks,118,9,1,0
2205,2021-05-15,Boston Celtics,124,Minnesota Timberwolves,108,-16,0,1
2206,2021-05-15,Phoenix Suns,140,San Antonio Spurs,103,-37,0,1
2207,2021-05-15,Miami Heat,108,Milwaukee Bucks,122,14,1,0
2208,2021-05-16,Boston Celtics,92,New York Knicks,96,4,1,0
2209,2021-05-16,Indiana Pacers,125,Toronto Raptors,113,-12,0,1
2210,2021-05-16,Charlotte Hornets,110,Washington Wizards,115,5,1,0
2211,2021-05-16,Phoenix Suns,123,San Antonio Spurs,121,-2,0,1
2212,2021-05-16,Memphis Grizzlies,101,Golden State Warriors,113,12,1,0
2213,2021-05-16,Houston Rockets,95,Atlanta Hawks,124,29,1,0
2214,2021-05-16,Cleveland Cavaliers,109,Brooklyn Nets,123,14,1,0
2215,2021-05-16,Orlando Magic,117,Philadelphia 76ers,128,11,1,0
2216,2021-05-16,Miami Heat,120,Detroit Pistons,107,-13,0,1
2217,2021-05-16,Milwaukee Bucks,112,Chicago Bulls,118,6,1,0
2218,2021-05-16,Dallas Mavericks,121,Minnesota Timberwolves,136,15,1,0
2219,2021-05-16,Los Angeles Lakers,110,New Orleans Pelicans,98,-12,0,1
2220,2021-05-16,Los Angeles Clippers,112,Oklahoma City Thunder,117,5,1,0
2221,2021-05-16,Denver Nuggets,116,Portland Trail Blazers,132,16,1,0
2222,2021-05-16,Utah Jazz,121,Sacramento Kings,99,-22,0,1
2223,2021-05-18,Charlotte Hornets,117,Indiana Pacers,144,27,1,0
2224,2021-05-18,Washington Wizards,100,Boston Celtics,118,18,1,0
2225,2021-05-19,San Antonio Spurs,96,Memphis Grizzlies,100,4,1,0
2226,2021-05-19,Golden State Warriors,100,Los Angeles Lakers,103,3,1,0
2227,2021-05-20,Indiana Pacers,115,Washington Wizards,142,27,1,0
2228,2021-05-21,Memphis Grizzlies,117,Golden State Warriors,112,-5,0,1
2229,2021-05-22,Miami Heat,107,Milwaukee Bucks,109,2,1,0
2230,2021-05-22,Dallas Mavericks,113,Los Angeles Clippers,103,-10,0,1
2231,2021-05-22,Boston Celtics,93,Brooklyn Nets,104,11,1,0
2232,2021-05-22,Portland Trail Blazers,123,Denver Nuggets,109,-14,0,1
2233,2021-05-23,Washington Wizards,118,Philadelphia 76ers,125,7,1,0
2234,2021-05-23,Los Angeles Lakers,90,Phoenix Suns,99,9,1,0
2235,2021-05-23,Atlanta Hawks,107,New York Knicks,105,-2,0,1
2236,2021-05-23,Memphis Grizzlies,112,Utah Jazz,109,-3,0,1
2237,2021-05-24,Miami Heat,98,Milwaukee Bucks,132,34,1,0
2238,2021-05-24,Portland Trail Blazers,109,Denver Nuggets,128,19,1,0
2239,2021-05-25,Boston Celtics,108,Brooklyn Nets,130,22,1,0
2240,2021-05-25,Los Angeles Lakers,109,Phoenix Suns,102,-7,0,1
2241,2021-05-25,Dallas Mavericks,127,Los Angeles Clippers,121,-6,0,1
2242,2021-05-26,Washington Wizards,95,Philadelphia 76ers,120,25,1,0
2243,2021-05-26,Atlanta Hawks,92,New York Knicks,101,9,1,0
2244,2021-05-26,Memphis Grizzlies,129,Utah Jazz,141,12,1,0
2245,2021-05-27,Milwaukee Bucks,113,Miami Heat,84,-29,0,1
2246,2021-05-27,Phoenix Suns,95,Los Angeles Lakers,109,14,1,0
2247,2021-05-27,Denver Nuggets,120,Portland Trail Blazers,115,-5,0,1
2248,2021-05-28,New York Knicks,94,Atlanta Hawks,105,11,1,0
2249,2021-05-28,Brooklyn Nets,119,Boston Celtics,125,6,1,0
2250,2021-05-28,Los Angeles Clippers,118,Dallas Mavericks,108,-10,0,1
2251,2021-05-29,Milwaukee Bucks,120,Miami Heat,103,-17,0,1
2252,2021-05-29,Denver Nuggets,95,Portland Trail Blazers,115,20,1,0
2253,2021-05-29,Philadelphia 76ers,132,Washington Wizards,103,-29,0,1
2254,2021-05-29,Utah Jazz,121,Memphis Grizzlies,111,-10,0,1
2255,2021-05-30,New York Knicks,96,Atlanta Hawks,113,17,1,0
2256,2021-05-30,Phoenix Suns,100,Los Angeles Lakers,92,-8,0,1
2257,2021-05-30,Brooklyn Nets,141,Boston Celtics,126,-15,0,1
2258,2021-05-30,Los Angeles Clippers,106,Dallas Mavericks,81,-25,0,1
2259,2021-05-31,Philadelphia 76ers,114,Washington Wizards,122,8,1,0
2260,2021-05-31,Utah Jazz,120,Memphis Grizzlies,113,-7,0,1
2261,2021-06-01,Boston Celtics,109,Brooklyn Nets,123,14,1,0
2262,2021-06-01,Portland Trail Blazers,140,Denver Nuggets,147,7,1,0
2263,2021-06-01,Los Angeles Lakers,85,Phoenix Suns,115,30,1,0
2264,2021-06-02,Washington Wizards,112,Philadelphia 76ers,129,17,1,0
2265,2021-06-02,Atlanta Hawks,103,New York Knicks,89,-14,0,1
2266,2021-06-02,Memphis Grizzlies,110,Utah Jazz,126,16,1,0
2267,2021-06-02,Dallas Mavericks,105,Los Angeles Clippers,100,-5,0,1
2268,2021-06-03,Denver Nuggets,126,Portland Trail Blazers,115,-11,0,1
2269,2021-06-03,Phoenix Suns,113,Los Angeles Lakers,100,-13,0,1
2270,2021-06-04,Los Angeles Clippers,104,Dallas Mavericks,97,-7,0,1
2271,2021-06-05,Milwaukee Bucks,107,Brooklyn Nets,115,8,1,0
2272,2021-06-06,Atlanta Hawks,128,Philadelphia 76ers,124,-4,0,1
2273,2021-06-06,Dallas Mavericks,111,Los Angeles Clippers,126,15,1,0
2274,2021-06-07,Milwaukee Bucks,86,Brooklyn Nets,125,39,1,0
2275,2021-06-07,Denver Nuggets,105,Phoenix Suns,122,17,1,0
2276,2021-06-08,Atlanta Hawks,102,Philadelphia 76ers,118,16,1,0
2277,2021-06-08,Los Angeles Clippers,109,Utah Jazz,112,3,1,0
2278,2021-06-09,Denver Nuggets,98,Phoenix Suns,123,25,1,0
2279,2021-06-10,Brooklyn Nets,83,Milwaukee Bucks,86,3,1,0
2280,2021-06-10,Los Angeles Clippers,111,Utah Jazz,117,6,1,0
2281,2021-06-11,Philadelphia 76ers,127,Atlanta Hawks,111,-16,0,1
2282,2021-06-11,Phoenix Suns,116,Denver Nuggets,102,-14,0,1
2283,2021-06-12,Utah Jazz,106,Los Angeles Clippers,132,26,1,0
2284,2021-06-13,Brooklyn Nets,96,Milwaukee Bucks,107,11,1,0
2285,2021-06-13,Phoenix Suns,125,Denver Nuggets,118,-7,0,1
2286,2021-06-14,Philadelphia 76ers,100,Atlanta Hawks,103,3,1,0
2287,2021-06-14,Utah Jazz,104,Los Angeles Clippers,118,14,1,0
2288,2021-06-15,Milwaukee Bucks,108,Brooklyn Nets,114,6,1,0
2289,2021-06-16,Atlanta Hawks,109,Philadelphia 76ers,106,-3,0,1
2290,2021-06-16,Los Angeles Clippers,119,Utah Jazz,111,-8,0,1
2291,2021-06-17,Brooklyn Nets,89,Milwaukee Bucks,104,15,1,0
2292,2021-06-18,Philadelphia 76ers,104,Atlanta Hawks,99,-5,0,1
2293,2021-06-18,Utah Jazz,119,Los Angeles Clippers,131,12,1,0
2294,2021-06-19,Milwaukee Bucks,115,Brooklyn Nets,111,-4,0,1
2295,2021-06-20,Los Angeles Clippers,114,Phoenix Suns,120,6,1,0
2296,2021-06-20,Atlanta Hawks,103,Philadelphia 76ers,96,-7,0,1
2297,2021-06-22,Los Angeles Clippers,103,Phoenix Suns,104,1,1,0
2298,2021-06-23,Atlanta Hawks,116,Milwaukee Bucks,113,-3,0,1
2299,2021-06-24,Phoenix Suns,92,Los Angeles Clippers,106,14,1,0
2300,2021-06-25,Atlanta Hawks,91,Milwaukee Bucks,125,34,1,0
2301,2021-06-26,Phoenix Suns,84,Los Angeles Clippers,80,-4,0,1
2302,2021-06-27,Milwaukee Bucks,113,Atlanta Hawks,102,-11,0,1
2303,2021-06-28,Los Angeles Clippers,116,Phoenix Suns,102,-14,0,1
2304,2021-06-29,Milwaukee Bucks,88,Atlanta Hawks,110,22,1,0
2305,2021-06-30,Phoenix Suns,130,Los Angeles Clippers,103,-27,0,1
2306,2021-07-01,Atlanta Hawks,112,Milwaukee Bucks,123,11,1,0
2307,2021-07-03,Milwaukee Bucks,118,Atlanta Hawks,107,-11,0,1
2308,2021-07-06,Milwaukee Bucks,105,Phoenix Suns,118,13,1,0
2309,2021-07-08,Milwaukee Bucks,108,Phoenix Suns,118,10,1,0
2310,2021-07-11,Phoenix Suns,100,Milwaukee Bucks,120,20,1,0
2311,2021-07-14,Phoenix Suns,103,Milwaukee Bucks,109,6,1,0
2312,2021-07-17,Milwaukee Bucks,123,Phoenix Suns,119,-4,0,1
2313,2021-07-20,Phoenix Suns,98,Milwaukee Bucks,105,7,1,0
2314,2021-10-19,Brooklyn Nets,104,Milwaukee Bucks,127,23,1,0
2315,2021-10-19,Golden State Warriors,121,Los Angeles Lakers,114,-7,0,1
2316,2021-10-20,Indiana Pacers,122,Charlotte Hornets,123,1,1,0
2317,2021-10-20,Chicago Bulls,94,Detroit Pistons,88,-6,0,1
2318,2021-10-20,Boston Celtics,134,New York Knicks,138,4,1,0
2319,2021-10-20,Washington Wizards,98,Toronto Raptors,83,-15,0,1
2320,2021-10-20,Cleveland Cavaliers,121,Memphis Grizzlies,132,11,1,0
2321,2021-10-20,Houston Rockets,106,Minnesota Timberwolves,124,18,1,0
2322,2021-10-20,Philadelphia 76ers,117,New Orleans Pelicans,97,-20,0,1
2323,2021-10-20,Orlando Magic,97,San Antonio Spurs,123,26,1,0
2324,2021-10-20,Oklahoma City Thunder,86,Utah Jazz,107,21,1,0
2325,2021-10-20,Sacramento Kings,124,Portland Trail Blazers,121,-3,0,1
2326,2021-10-20,Denver Nuggets,110,Phoenix Suns,98,-12,0,1
2327,2021-10-21,Dallas Mavericks,87,Atlanta Hawks,113,26,1,0
2328,2021-10-21,Milwaukee Bucks,95,Miami Heat,137,42,1,0
2329,2021-10-21,Los Angeles Clippers,113,Golden State Warriors,115,2,1,0
2330,2021-10-22,New York Knicks,121,Orlando Magic,96,-25,0,1
2331,2021-10-22,Indiana Pacers,134,Washington Wizards,135,1,1,0
2332,2021-10-22,Charlotte Hornets,123,Cleveland Cavaliers,112,-11,0,1
2333,2021-10-22,Toronto Raptors,115,Boston Celtics,83,-32,0,1
2334,2021-10-22,Brooklyn Nets,114,Philadelphia 76ers,109,-5,0,1
2335,2021-10-22,Oklahoma City Thunder,91,Houston Rockets,124,33,1,0
2336,2021-10-22,New Orleans Pelicans,112,Chicago Bulls,128,16,1,0
2337,2021-10-22,San Antonio Spurs,96,Denver Nuggets,102,6,1,0
2338,2021-10-22,Phoenix Suns,115,Los Angeles Lakers,105,-10,0,1
2339,2021-10-22,Utah Jazz,110,Sacramento Kings,101,-9,0,1
2340,2021-10-23,Atlanta Hawks,95,Cleveland Cavaliers,101,6,1,0
2341,2021-10-23,Miami Heat,91,Indiana Pacers,102,11,1,0
2342,2021-10-23,Dallas Mavericks,103,Toronto Raptors,95,-8,0,1
2343,2021-10-23,Detroit Pistons,82,Chicago Bulls,97,15,1,0
2344,2021-10-23,New Orleans Pelicans,89,Minnesota Timberwolves,96,7,1,0
2345,2021-10-23,Milwaukee Bucks,121,San Antonio Spurs,111,-10,0,1
2346,2021-10-23,Phoenix Suns,105,Portland Trail Blazers,134,29,1,0
2347,2021-10-23,Memphis Grizzlies,120,Los Angeles Clippers,114,-6,0,1
2348,2021-10-24,Charlotte Hornets,111,Brooklyn Nets,95,-16,0,1
2349,2021-10-24,Boston Celtics,107,Houston Rockets,97,-10,0,1
2350,2021-10-24,Orlando Magic,110,New York Knicks,104,-6,0,1
2351,2021-10-24,Philadelphia 76ers,115,Oklahoma City Thunder,103,-12,0,1
2352,2021-10-24,Golden State Warriors,119,Sacramento Kings,107,-12,0,1
2353,2021-10-24,Memphis Grizzlies,118,Los Angeles Lakers,121,3,1,0
2354,2021-10-25,Boston Celtics,140,Charlotte Hornets,129,-11,0,1
2355,2021-10-25,Milwaukee Bucks,119,Indiana Pacers,109,-10,0,1
2356,2021-10-25,Chicago Bulls,111,Toronto Raptors,108,-3,0,1
2357,2021-10-25,Orlando Magic,90,Miami Heat,107,17,1,0
2358,2021-10-25,Washington Wizards,90,Brooklyn Nets,104,14,1,0
2359,2021-10-25,Detroit Pistons,104,Atlanta Hawks,122,18,1,0
2360,2021-10-25,New Orleans Pelicans,107,Minnesota Timberwolves,98,-9,0,1
2361,2021-10-25,Cleveland Cavaliers,99,Denver Nuggets,87,-12,0,1
2362,2021-10-25,Portland Trail Blazers,86,Los Angeles Clippers,116,30,1,0
2363,2021-10-26,Philadelphia 76ers,99,New York Knicks,112,13,1,0
2364,2021-10-26,Golden State Warriors,106,Oklahoma City Thunder,98,-8,0,1
2365,2021-10-26,Los Angeles Lakers,125,San Antonio Spurs,121,-4,0,1
2366,2021-10-26,Houston Rockets,106,Dallas Mavericks,116,10,1,0
2367,2021-10-26,Denver Nuggets,110,Utah Jazz,122,12,1,0
2368,2021-10-27,Charlotte Hornets,120,Orlando Magic,111,-9,0,1
2369,2021-10-27,Washington Wizards,116,Boston Celtics,107,-9,0,1
2370,2021-10-27,Miami Heat,106,Brooklyn Nets,93,-13,0,1
2371,2021-10-27,Indiana Pacers,100,Toronto Raptors,118,18,1,0
2372,2021-10-27,Atlanta Hawks,102,New Orleans Pelicans,99,-3,0,1
2373,2021-10-27,Minnesota Timberwolves,113,Milwaukee Bucks,108,-5,0,1
2374,2021-10-27,Los Angeles Lakers,115,Oklahoma City Thunder,123,8,1,0
2375,2021-10-27,Sacramento Kings,110,Phoenix Suns,107,-3,0,1
2376,2021-10-27,Memphis Grizzlies,96,Portland Trail Blazers,116,20,1,0
2377,2021-10-27,Cleveland Cavaliers,92,Los Angeles Clippers,79,-13,0,1
2378,2021-10-28,Atlanta Hawks,111,Washington Wizards,122,11,1,0
2379,2021-10-28,Detroit Pistons,102,Philadelphia 76ers,110,8,1,0
2380,2021-10-28,Utah Jazz,122,Houston Rockets,91,-31,0,1
2381,2021-10-28,New York Knicks,104,Chicago Bulls,103,-1,0,1
2382,2021-10-28,San Antonio Spurs,99,Dallas Mavericks,104,5,1,0
2383,2021-10-28,Memphis Grizzlies,104,Golden State Warriors,101,-3,0,1
2384,2021-10-29,Orlando Magic,109,Toronto Raptors,110,1,1,0
2385,2021-10-29,Charlotte Hornets,99,Miami Heat,114,15,1,0
2386,2021-10-29,Indiana Pacers,98,Brooklyn Nets,105,7,1,0
2387,2021-10-29,Sacramento Kings,113,New Orleans Pelicans,109,-4,0,1
2388,2021-10-29,Dallas Mavericks,75,Denver Nuggets,106,31,1,0
2389,2021-10-29,Los Angeles Clippers,92,Portland Trail Blazers,111,19,1,0
2390,2021-10-29,Cleveland Cavaliers,101,Los Angeles Lakers,113,12,1,0
2391,2021-10-30,Boston Celtics,112,Washington Wizards,115,3,1,0
2392,2021-10-30,Orlando Magic,103,Detroit Pistons,110,7,1,0
2393,2021-10-30,New York Knicks,123,New Orleans Pelicans,117,-6,0,1
2394,2021-10-30,Toronto Raptors,97,Indiana Pacers,94,-3,0,1
2395,2021-10-30,Atlanta Hawks,94,Philadelphia 76ers,122,28,1,0
2396,2021-10-30,Utah Jazz,99,Chicago Bulls,107,8,1,0
2397,2021-10-30,Miami Heat,129,Memphis Grizzlies,103,-26,0,1
2398,2021-10-30,San Antonio Spurs,102,Milwaukee Bucks,93,-9,0,1
2399,2021-10-30,Oklahoma City Thunder,82,Golden State Warriors,103,21,1,0
2400,2021-10-30,Denver Nuggets,93,Minnesota Timberwolves,91,-2,0,1
2401,2021-10-30,Cleveland Cavaliers,92,Phoenix Suns,101,9,1,0
2402,2021-10-31,Sacramento Kings,99,Dallas Mavericks,105,6,1,0
2403,2021-10-31,Portland Trail Blazers,113,Charlotte Hornets,125,12,1,0
2404,2021-10-31,Utah Jazz,107,Milwaukee Bucks,95,-12,0,1
2405,2021-10-31,Detroit Pistons,91,Brooklyn Nets,117,26,1,0
2406,2021-10-31,Houston Rockets,85,Los Angeles Lakers,95,10,1,0
2407,2021-11-01,Cleveland Cavaliers,113,Charlotte Hornets,110,-3,0,1
2408,2021-11-01,San Antonio Spurs,118,Indiana Pacers,131,13,1,0
2409,2021-11-01,Portland Trail Blazers,103,Philadelphia 76ers,113,10,1,0
2410,2021-11-01,Washington Wizards,111,Atlanta Hawks,118,7,1,0
2411,2021-11-01,Chicago Bulls,128,Boston Celtics,114,-14,0,1
2412,2021-11-01,Toronto Raptors,113,New York Knicks,104,-9,0,1
2413,2021-11-01,Denver Nuggets,97,Memphis Grizzlies,106,9,1,0
2414,2021-11-01,Orlando Magic,115,Minnesota Timberwolves,97,-18,0,1
2415,2021-11-01,Oklahoma City Thunder,94,Los Angeles Clippers,99,5,1,0
2416,2021-11-02,Milwaukee Bucks,117,Detroit Pistons,89,-28,0,1
2417,2021-11-02,Miami Heat,125,Dallas Mavericks,110,-15,0,1
2418,2021-11-02,Sacramento Kings,113,Utah Jazz,119,6,1,0
2419,2021-11-02,New Orleans Pelicans,100,Phoenix Suns,112,12,1,0
2420,2021-11-02,Houston Rockets,117,Los Angeles Lakers,119,2,1,0
2421,2021-11-03,Portland Trail Blazers,104,Cleveland Cavaliers,107,3,1,0
2422,2021-11-03,New York Knicks,98,Indiana Pacers,111,13,1,0
2423,2021-11-03,Boston Celtics,92,Orlando Magic,79,-13,0,1
2424,2021-11-03,Chicago Bulls,98,Philadelphia 76ers,103,5,1,0
2425,2021-11-03,Toronto Raptors,109,Washington Wizards,100,-9,0,1
2426,2021-11-03,Atlanta Hawks,108,Brooklyn Nets,117,9,1,0
2427,2021-11-03,Denver Nuggets,106,Memphis Grizzlies,108,2,1,0
2428,2021-11-03,Los Angeles Clippers,126,Minnesota Timberwolves,115,-11,0,1
2429,2021-11-03,Dallas Mavericks,109,San Antonio Spurs,108,-1,0,1
2430,2021-11-03,Charlotte Hornets,92,Golden State Warriors,114,22,1,0
2431,2021-11-03,New Orleans Pelicans,99,Sacramento Kings,112,13,1,0
2432,2021-11-04,Philadelphia 76ers,109,Detroit Pistons,98,-11,0,1
2433,2021-11-04,Utah Jazz,116,Atlanta Hawks,98,-18,0,1
2434,2021-11-04,Boston Celtics,95,Miami Heat,78,-17,0,1
2435,2021-11-04,Houston Rockets,111,Phoenix Suns,123,12,1,0
2436,2021-11-04,Oklahoma City Thunder,107,Los Angeles Lakers,104,-3,0,1
2437,2021-11-05,Brooklyn Nets,96,Detroit Pistons,90,-6,0,1
2438,2021-11-05,San Antonio Spurs,102,Orlando Magic,89,-13,0,1
2439,2021-11-05,Memphis Grizzlies,87,Washington Wizards,115,28,1,0
2440,2021-11-05,New York Knicks,113,Milwaukee Bucks,98,-15,0,1
2441,2021-11-05,Cleveland Cavaliers,102,Toronto Raptors,101,-1,0,1
2442,2021-11-05,Los Angeles Clippers,104,Minnesota Timberwolves,84,-20,0,1
2443,2021-11-05,New Orleans Pelicans,85,Golden State Warriors,126,41,1,0
2444,2021-11-05,Indiana Pacers,106,Portland Trail Blazers,110,4,1,0
2445,2021-11-05,Charlotte Hornets,110,Sacramento Kings,140,30,1,0
2446,2021-11-06,Houston Rockets,94,Denver Nuggets,95,1,1,0
2447,2021-11-06,Utah Jazz,115,Miami Heat,118,3,1,0
2448,2021-11-06,Philadelphia 76ers,114,Chicago Bulls,105,-9,0,1
2449,2021-11-06,Boston Celtics,104,Dallas Mavericks,107,3,1,0
2450,2021-11-06,Atlanta Hawks,117,Phoenix Suns,121,4,1,0
2451,2021-11-06,Los Angeles Lakers,90,Portland Trail Blazers,105,15,1,0
2452,2021-11-07,Brooklyn Nets,116,Toronto Raptors,103,-13,0,1
2453,2021-11-07,Cleveland Cavaliers,126,New York Knicks,109,-17,0,1
2454,2021-11-07,Utah Jazz,100,Orlando Magic,107,7,1,0
2455,2021-11-07,Indiana Pacers,94,Sacramento Kings,91,-3,0,1
2456,2021-11-07,Milwaukee Bucks,94,Washington Wizards,101,7,1,0
2457,2021-11-07,San Antonio Spurs,94,Oklahoma City Thunder,99,5,1,0
2458,2021-11-07,Houston Rockets,107,Golden State Warriors,120,13,1,0
2459,2021-11-07,Charlotte Hornets,106,Los Angeles Clippers,120,14,1,0
2460,2021-11-08,New York Knicks,103,Philadelphia 76ers,96,-7,0,1
2461,2021-11-08,Brooklyn Nets,95,Chicago Bulls,118,23,1,0
2462,2021-11-08,Minnesota Timberwolves,118,Memphis Grizzlies,125,7,1,0
2463,2021-11-08,New Orleans Pelicans,92,Dallas Mavericks,108,16,1,0
2464,2021-11-08,Miami Heat,96,Denver Nuggets,113,17,1,0
2465,2021-11-08,Atlanta Hawks,113,Golden State Warriors,127,14,1,0
2466,2021-11-08,Phoenix Suns,109,Sacramento Kings,104,-5,0,1
2467,2021-11-08,Charlotte Hornets,123,Los Angeles Lakers,126,3,1,0
2468,2021-11-09,Milwaukee Bucks,118,Philadelphia 76ers,109,-9,0,1
2469,2021-11-09,Atlanta Hawks,98,Utah Jazz,110,12,1,0
2470,2021-11-09,Portland Trail Blazers,109,Los Angeles Clippers,117,8,1,0
2471,2021-11-10,Washington Wizards,97,Cleveland Cavaliers,94,-3,0,1
2472,2021-11-10,Brooklyn Nets,123,Orlando Magic,90,-33,0,1
2473,2021-11-10,Toronto Raptors,88,Boston Celtics,104,16,1,0
2474,2021-11-10,Detroit Pistons,112,Houston Rockets,104,-8,0,1
2475,2021-11-10,Milwaukee Bucks,112,New York Knicks,100,-12,0,1
2476,2021-11-10,Dallas Mavericks,107,Chicago Bulls,117,10,1,0
2477,2021-11-10,Charlotte Hornets,118,Memphis Grizzlies,108,-10,0,1
2478,2021-11-10,Oklahoma City Thunder,108,New Orleans Pelicans,100,-8,0,1
2479,2021-11-10,Sacramento Kings,117,San Antonio Spurs,136,19,1,0
2480,2021-11-10,Indiana Pacers,98,Denver Nuggets,101,3,1,0
2481,2021-11-10,Portland Trail Blazers,109,Phoenix Suns,119,10,1,0
2482,2021-11-10,Minnesota Timberwolves,110,Golden State Warriors,123,13,1,0
2483,2021-11-10,Miami Heat,117,Los Angeles Lakers,120,3,1,0
2484,2021-11-11,Toronto Raptors,115,Philadelphia 76ers,109,-6,0,1
2485,2021-11-11,Indiana Pacers,111,Utah Jazz,100,-11,0,1
2486,2021-11-11,Miami Heat,109,Los Angeles Clippers,112,3,1,0
2487,2021-11-12,New York Knicks,96,Charlotte Hornets,104,8,1,0
2488,2021-11-12,Milwaukee Bucks,113,Boston Celtics,122,9,1,0
2489,2021-11-12,Detroit Pistons,78,Cleveland Cavaliers,98,20,1,0
2490,2021-11-12,Portland Trail Blazers,104,Houston Rockets,92,-12,0,1
2491,2021-11-12,Phoenix Suns,119,Memphis Grizzlies,94,-25,0,1
2492,2021-11-12,Brooklyn Nets,120,New Orleans Pelicans,112,-8,0,1
2493,2021-11-12,Sacramento Kings,103,Oklahoma City Thunder,105,2,1,0
2494,2021-11-12,Dallas Mavericks,123,San Antonio Spurs,109,-14,0,1
2495,2021-11-12,Atlanta Hawks,96,Denver Nuggets,105,9,1,0
2496,2021-11-12,Chicago Bulls,93,Golden State Warriors,119,26,1,0
2497,2021-11-12,Minnesota Timberwolves,107,Los Angeles Lakers,83,-24,0,1
2498,2021-11-13,Miami Heat,111,Utah Jazz,105,-6,0,1
2499,2021-11-13,Philadelphia 76ers,113,Indiana Pacers,118,5,1,0
2500,2021-11-13,Memphis Grizzlies,101,New Orleans Pelicans,112,11,1,0
2501,2021-11-13,Washington Wizards,104,Orlando Magic,92,-12,0,1
2502,2021-11-13,Detroit Pistons,127,Toronto Raptors,121,-6,0,1
2503,2021-11-13,Boston Celtics,89,Cleveland Cavaliers,91,2,1,0
2504,2021-11-13,Minnesota Timberwolves,102,Los Angeles Clippers,129,27,1,0
2505,2021-11-14,San Antonio Spurs,106,Los Angeles Lakers,114,8,1,0
2506,2021-11-14,Milwaukee Bucks,100,Atlanta Hawks,120,20,1,0
2507,2021-11-14,Golden State Warriors,102,Charlotte Hornets,106,4,1,0
2508,2021-11-14,Phoenix Suns,115,Houston Rockets,89,-26,0,1
2509,2021-11-14,Brooklyn Nets,120,Oklahoma City Thunder,96,-24,0,1
2510,2021-11-14,Portland Trail Blazers,95,Denver Nuggets,124,29,1,0
2511,2021-11-14,Chicago Bulls,100,Los Angeles Clippers,90,-10,0,1
2512,2021-11-15,Boston Celtics,98,Cleveland Cavaliers,92,-6,0,1
2513,2021-11-15,Sacramento Kings,129,Detroit Pistons,107,-22,0,1
2514,2021-11-15,New Orleans Pelicans,100,Washington Wizards,105,5,1,0
2515,2021-11-15,Orlando Magic,111,Atlanta Hawks,129,18,1,0
2516,2021-11-15,Indiana Pacers,84,New York Knicks,92,8,1,0
2517,2021-11-15,Denver Nuggets,101,Dallas Mavericks,111,10,1,0
2518,2021-11-15,Houston Rockets,102,Memphis Grizzlies,136,34,1,0
2519,2021-11-15,Phoenix Suns,99,Minnesota Timberwolves,96,-3,0,1
2520,2021-11-15,Miami Heat,103,Oklahoma City Thunder,90,-13,0,1
2521,2021-11-15,Toronto Raptors,113,Portland Trail Blazers,118,5,1,0
2522,2021-11-15,Chicago Bulls,121,Los Angeles Lakers,103,-18,0,1
2523,2021-11-16,Golden State Warriors,117,Brooklyn Nets,99,-18,0,1
2524,2021-11-16,Philadelphia 76ers,85,Utah Jazz,120,35,1,0
2525,2021-11-16,San Antonio Spurs,92,Los Angeles Clippers,106,14,1,0
2526,2021-11-17,Washington Wizards,87,Charlotte Hornets,97,10,1,0
2527,2021-11-17,Indiana Pacers,89,Detroit Pistons,97,8,1,0
2528,2021-11-17,Boston Celtics,99,Atlanta Hawks,110,11,1,0
2529,2021-11-17,Cleveland Cavaliers,99,Brooklyn Nets,109,10,1,0
2530,2021-11-17,New Orleans Pelicans,98,Miami Heat,113,15,1,0
2531,2021-11-17,Los Angeles Lakers,102,Milwaukee Bucks,109,7,1,0
2532,2021-11-17,Orlando Magic,104,New York Knicks,98,-6,0,1
2533,2021-11-17,Sacramento Kings,97,Minnesota Timberwolves,107,10,1,0
2534,2021-11-17,Houston Rockets,89,Oklahoma City Thunder,101,12,1,0
2535,2021-11-17,Dallas Mavericks,98,Phoenix Suns,105,7,1,0
2536,2021-11-17,Chicago Bulls,107,Portland Trail Blazers,112,5,1,0
2537,2021-11-18,Golden State Warriors,104,Cleveland Cavaliers,89,-15,0,1
2538,2021-11-18,Washington Wizards,97,Miami Heat,112,15,1,0
2539,2021-11-18,Los Angeles Clippers,108,Memphis Grizzlies,120,12,1,0
2540,2021-11-18,San Antonio Spurs,90,Minnesota Timberwolves,115,25,1,0
2541,2021-11-18,Philadelphia 76ers,103,Denver Nuggets,89,-14,0,1
2542,2021-11-18,Toronto Raptors,103,Utah Jazz,119,16,1,0
2543,2021-11-19,Indiana Pacers,118,Charlotte Hornets,121,3,1,0
2544,2021-11-19,Golden State Warriors,105,Detroit Pistons,102,-3,0,1
2545,2021-11-19,Los Angeles Lakers,108,Boston Celtics,130,22,1,0
2546,2021-11-19,Orlando Magic,113,Brooklyn Nets,115,2,1,0
2547,2021-11-19,Oklahoma City Thunder,89,Milwaukee Bucks,96,7,1,0
2548,2021-11-19,Los Angeles Clippers,81,New Orleans Pelicans,94,13,1,0
2549,2021-11-19,Chicago Bulls,114,Denver Nuggets,108,-6,0,1
2550,2021-11-19,Dallas Mavericks,104,Phoenix Suns,112,8,1,0
2551,2021-11-19,Toronto Raptors,108,Sacramento Kings,89,-19,0,1
2552,2021-11-20,Houston Rockets,99,New York Knicks,106,7,1,0
2553,2021-11-20,New Orleans Pelicans,94,Indiana Pacers,111,17,1,0
2554,2021-11-20,Miami Heat,100,Washington Wizards,103,3,1,0
2555,2021-11-20,Charlotte Hornets,105,Atlanta Hawks,115,10,1,0
2556,2021-11-20,Oklahoma City Thunder,105,Boston Celtics,111,6,1,0
2557,2021-11-20,Orlando Magic,108,Milwaukee Bucks,117,9,1,0
2558,2021-11-20,Memphis Grizzlies,95,Minnesota Timberwolves,138,43,1,0
2559,2021-11-20,Philadelphia 76ers,111,Portland Trail Blazers,118,7,1,0
2560,2021-11-20,Utah Jazz,123,Sacramento Kings,105,-18,0,1
2561,2021-11-21,Dallas Mavericks,91,Los Angeles Clippers,97,6,1,0
2562,2021-11-21,Los Angeles Lakers,121,Detroit Pistons,116,-5,0,1
2563,2021-11-21,New York Knicks,103,Chicago Bulls,109,6,1,0
2564,2021-11-21,Denver Nuggets,97,Phoenix Suns,126,29,1,0
2565,2021-11-21,Toronto Raptors,104,Golden State Warriors,119,15,1,0
2566,2021-11-22,Brooklyn Nets,117,Cleveland Cavaliers,112,-5,0,1
2567,2021-11-22,Charlotte Hornets,109,Washington Wizards,103,-6,0,1
2568,2021-11-22,Oklahoma City Thunder,101,Atlanta Hawks,113,12,1,0
2569,2021-11-22,Houston Rockets,90,Boston Celtics,108,18,1,0
2570,2021-11-22,Indiana Pacers,109,Chicago Bulls,77,-32,0,1
2571,2021-11-22,Orlando Magic,92,Milwaukee Bucks,123,31,1,0
2572,2021-11-22,Minnesota Timberwolves,110,New Orleans Pelicans,96,-14,0,1
2573,2021-11-22,Phoenix Suns,115,San Antonio Spurs,111,-4,0,1
2574,2021-11-22,Memphis Grizzlies,119,Utah Jazz,118,-1,0,1
2575,2021-11-22,Philadelphia 76ers,102,Sacramento Kings,94,-8,0,1
2576,2021-11-23,Miami Heat,100,Detroit Pistons,92,-8,0,1
2577,2021-11-23,Los Angeles Lakers,100,New York Knicks,106,6,1,0
2578,2021-11-23,Denver Nuggets,100,Portland Trail Blazers,119,19,1,0
2579,2021-11-23,Dallas Mavericks,112,Los Angeles Clippers,104,-8,0,1
2580,2021-11-24,Phoenix Suns,120,Cleveland Cavaliers,115,-5,0,1
2581,2021-11-24,Los Angeles Lakers,124,Indiana Pacers,116,-8,0,1
2582,2021-11-24,Charlotte Hornets,106,Orlando Magic,99,-7,0,1
2583,2021-11-24,Brooklyn Nets,123,Boston Celtics,104,-19,0,1
2584,2021-11-24,Chicago Bulls,113,Houston Rockets,118,5,1,0
2585,2021-11-24,Toronto Raptors,126,Memphis Grizzlies,113,-13,0,1
2586,2021-11-24,Detroit Pistons,93,Milwaukee Bucks,114,21,1,0
2587,2021-11-24,Miami Heat,101,Minnesota Timberwolves,113,12,1,0
2588,2021-11-24,Washington Wizards,102,New Orleans Pelicans,127,25,1,0
2589,2021-11-24,Utah Jazz,110,Oklahoma City Thunder,104,-6,0,1
2590,2021-11-24,Atlanta Hawks,124,San Antonio Spurs,106,-18,0,1
2591,2021-11-24,Philadelphia 76ers,96,Golden State Warriors,116,20,1,0
2592,2021-11-24,Portland Trail Blazers,121,Sacramento Kings,125,4,1,0
2593,2021-11-26,Detroit Pistons,96,Los Angeles Clippers,107,11,1,0
2594,2021-11-26,Minnesota Timberwolves,115,Charlotte Hornets,133,18,1,0
2595,2021-11-26,Phoenix Suns,118,New York Knicks,97,-21,0,1
2596,2021-11-26,Chicago Bulls,123,Orlando Magic,88,-35,0,1
2597,2021-11-26,Toronto Raptors,97,Indiana Pacers,114,17,1,0
2598,2021-11-26,Atlanta Hawks,132,Memphis Grizzlies,100,-32,0,1
2599,2021-11-26,Washington Wizards,101,Oklahoma City Thunder,99,-2,0,1
2600,2021-11-26,Boston Celtics,88,San Antonio Spurs,96,8,1,0
2601,2021-11-26,Milwaukee Bucks,120,Denver Nuggets,109,-11,0,1
2602,2021-11-26,New Orleans Pelicans,98,Utah Jazz,97,-1,0,1
2603,2021-11-26,Portland Trail Blazers,103,Golden State Warriors,118,15,1,0
2604,2021-11-26,Sacramento Kings,141,Los Angeles Lakers,137,-4,0,1
2605,2021-11-27,Minnesota Timberwolves,121,Philadelphia 76ers,120,-1,0,1
2606,2021-11-27,New York Knicks,99,Atlanta Hawks,90,-9,0,1
2607,2021-11-27,Phoenix Suns,113,Brooklyn Nets,107,-6,0,1
2608,2021-11-27,Miami Heat,107,Chicago Bulls,104,-3,0,1
2609,2021-11-27,Orlando Magic,92,Cleveland Cavaliers,105,13,1,0
2610,2021-11-27,Charlotte Hornets,143,Houston Rockets,146,3,1,0
2611,2021-11-27,Washington Wizards,120,Dallas Mavericks,114,-6,0,1
2612,2021-11-27,New Orleans Pelicans,105,Utah Jazz,127,22,1,0
2613,2021-11-28,Golden State Warriors,105,Los Angeles Clippers,90,-15,0,1
2614,2021-11-28,Milwaukee Bucks,118,Indiana Pacers,100,-18,0,1
2615,2021-11-28,Sacramento Kings,101,Memphis Grizzlies,128,27,1,0
2616,2021-11-28,Boston Celtics,109,Toronto Raptors,97,-12,0,1
2617,2021-11-28,Detroit Pistons,106,Los Angeles Lakers,110,4,1,0
2618,2021-11-29,Orlando Magic,96,Philadelphia 76ers,101,5,1,0
2619,2021-11-29,Denver Nuggets,120,Miami Heat,111,-9,0,1
2620,2021-11-29,Charlotte Hornets,119,Chicago Bulls,133,14,1,0
2621,2021-11-29,Oklahoma City Thunder,89,Houston Rockets,102,13,1,0
2622,2021-11-29,Indiana Pacers,98,Minnesota Timberwolves,100,2,1,0
2623,2021-11-29,Cleveland Cavaliers,114,Dallas Mavericks,96,-18,0,1
2624,2021-11-29,Washington Wizards,99,San Antonio Spurs,116,17,1,0
2625,2021-11-29,Portland Trail Blazers,107,Utah Jazz,129,22,1,0
2626,2021-11-29,New Orleans Pelicans,123,Los Angeles Clippers,104,-19,0,1
2627,2021-11-30,New York Knicks,110,Brooklyn Nets,112,2,1,0
2628,2021-11-30,Memphis Grizzlies,98,Toronto Raptors,91,-7,0,1
2629,2021-11-30,Golden State Warriors,96,Phoenix Suns,104,8,1,0
2630,2021-11-30,Detroit Pistons,92,Portland Trail Blazers,110,18,1,0
2631,2021-11-30,Los Angeles Lakers,117,Sacramento Kings,92,-25,0,1
2632,2021-12-01,Atlanta Hawks,114,Indiana Pacers,111,-3,0,1
2633,2021-12-01,Denver Nuggets,103,Orlando Magic,108,5,1,0
2634,2021-12-01,Minnesota Timberwolves,107,Washington Wizards,115,8,1,0
2635,2021-12-01,Philadelphia 76ers,87,Boston Celtics,88,1,1,0
2636,2021-12-01,Cleveland Cavaliers,111,Miami Heat,85,-26,0,1
2637,2021-12-01,Charlotte Hornets,125,Milwaukee Bucks,127,2,1,0
2638,2021-12-01,Dallas Mavericks,139,New Orleans Pelicans,107,-32,0,1
2639,2021-12-01,Houston Rockets,114,Oklahoma City Thunder,110,-4,0,1
2640,2021-12-01,Sacramento Kings,124,Los Angeles Clippers,115,-9,0,1
2641,2021-12-02,Chicago Bulls,119,New York Knicks,115,-4,0,1
2642,2021-12-02,Milwaukee Bucks,93,Toronto Raptors,97,4,1,0
2643,2021-12-02,Oklahoma City Thunder,79,Memphis Grizzlies,152,73,1,0
2644,2021-12-02,Detroit Pistons,103,Phoenix Suns,114,11,1,0
2645,2021-12-02,San Antonio Spurs,114,Portland Trail Blazers,83,-31,0,1
2646,2021-12-03,Miami Heat,113,Indiana Pacers,104,-9,0,1
2647,2021-12-03,Cleveland Cavaliers,116,Washington Wizards,101,-15,0,1
2648,2021-12-03,Philadelphia 76ers,98,Atlanta Hawks,96,-2,0,1
2649,2021-12-03,Minnesota Timberwolves,105,Brooklyn Nets,110,5,1,0
2650,2021-12-03,Orlando Magic,116,Houston Rockets,118,2,1,0
2651,2021-12-03,New Orleans Pelicans,107,Dallas Mavericks,91,-16,0,1
2652,2021-12-03,Boston Celtics,130,Utah Jazz,137,7,1,0
2653,2021-12-03,Phoenix Suns,96,Golden State Warriors,118,22,1,0
2654,2021-12-03,Los Angeles Clippers,119,Los Angeles Lakers,115,-4,0,1
2655,2021-12-04,Denver Nuggets,113,New York Knicks,99,-14,0,1
2656,2021-12-04,Chicago Bulls,111,Brooklyn Nets,107,-4,0,1
2657,2021-12-04,Miami Heat,102,Milwaukee Bucks,124,22,1,0
2658,2021-12-04,Memphis Grizzlies,97,Dallas Mavericks,90,-7,0,1
2659,2021-12-04,San Antonio Spurs,112,Golden State Warriors,107,-5,0,1
2660,2021-12-04,Boston Celtics,145,Portland Trail Blazers,117,-28,0,1
2661,2021-12-04,Los Angeles Clippers,99,Sacramento Kings,104,5,1,0
2662,2021-12-05,Utah Jazz,109,Cleveland Cavaliers,108,-1,0,1
2663,2021-12-05,Charlotte Hornets,130,Atlanta Hawks,127,-3,0,1
2664,2021-12-05,Washington Wizards,90,Toronto Raptors,102,12,1,0
2665,2021-12-05,New Orleans Pelicans,108,Houston Rockets,118,10,1,0
2666,2021-12-06,Philadelphia 76ers,127,Charlotte Hornets,124,-3,0,1
2667,2021-12-06,Oklahoma City Thunder,114,Detroit Pistons,103,-11,0,1
2668,2021-12-06,Washington Wizards,110,Indiana Pacers,116,6,1,0
2669,2021-12-06,Memphis Grizzlies,105,Miami Heat,90,-15,0,1
2670,2021-12-06,Denver Nuggets,97,Chicago Bulls,109,12,1,0
2671,2021-12-06,Cleveland Cavaliers,104,Milwaukee Bucks,112,8,1,0
2672,2021-12-06,Atlanta Hawks,121,Minnesota Timberwolves,110,-11,0,1
2673,2021-12-06,San Antonio Spurs,104,Phoenix Suns,108,4,1,0
2674,2021-12-06,Orlando Magic,95,Golden State Warriors,126,31,1,0
2675,2021-12-06,Los Angeles Clippers,102,Portland Trail Blazers,90,-12,0,1
2676,2021-12-07,Brooklyn Nets,102,Dallas Mavericks,99,-3,0,1
2677,2021-12-07,New York Knicks,121,San Antonio Spurs,109,-12,0,1
2678,2021-12-07,Boston Celtics,102,Los Angeles Lakers,117,15,1,0
2679,2021-12-08,Philadelphia 76ers,110,Charlotte Hornets,106,-4,0,1
2680,2021-12-08,Chicago Bulls,92,Cleveland Cavaliers,115,23,1,0
2681,2021-12-08,Washington Wizards,119,Detroit Pistons,116,-3,0,1
2682,2021-12-08,New York Knicks,102,Indiana Pacers,122,20,1,0
2683,2021-12-08,Milwaukee Bucks,104,Miami Heat,113,9,1,0
2684,2021-12-08,Oklahoma City Thunder,110,Toronto Raptors,109,-1,0,1
2685,2021-12-08,Brooklyn Nets,104,Houston Rockets,114,10,1,0
2686,2021-12-08,Dallas Mavericks,104,Memphis Grizzlies,96,-8,0,1
2687,2021-12-08,Utah Jazz,136,Minnesota Timberwolves,104,-32,0,1
2688,2021-12-08,Denver Nuggets,120,New Orleans Pelicans,114,-6,0,1
2689,2021-12-08,Portland Trail Blazers,94,Golden State Warriors,104,10,1,0
2690,2021-12-08,Orlando Magic,130,Sacramento Kings,142,12,1,0
2691,2021-12-08,Boston Celtics,111,Los Angeles Clippers,114,3,1,0
2692,2021-12-09,Utah Jazz,118,Philadelphia 76ers,96,-22,0,1
2693,2021-12-09,Los Angeles Lakers,95,Memphis Grizzlies,108,13,1,0
2694,2021-12-09,Denver Nuggets,111,San Antonio Spurs,123,12,1,0
2695,2021-12-10,Sacramento Kings,123,Charlotte Hornets,124,1,1,0
2696,2021-12-10,Dallas Mavericks,93,Indiana Pacers,106,13,1,0
2697,2021-12-10,Brooklyn Nets,113,Atlanta Hawks,105,-8,0,1
2698,2021-12-10,New York Knicks,87,Toronto Raptors,90,3,1,0
2699,2021-12-10,Milwaukee Bucks,123,Houston Rockets,114,-9,0,1
2700,2021-12-10,Cleveland Cavaliers,123,Minnesota Timberwolves,106,-17,0,1
2701,2021-12-10,Detroit Pistons,93,New Orleans Pelicans,109,16,1,0
2702,2021-12-10,Los Angeles Lakers,116,Oklahoma City Thunder,95,-21,0,1
2703,2021-12-10,Boston Celtics,90,Phoenix Suns,111,21,1,0
2704,2021-12-11,Orlando Magic,104,Los Angeles Clippers,106,2,1,0
2705,2021-12-11,Utah Jazz,123,Washington Wizards,98,-25,0,1
2706,2021-12-11,Sacramento Kings,103,Cleveland Cavaliers,117,14,1,0
2707,2021-12-11,Houston Rockets,106,Memphis Grizzlies,113,7,1,0
2708,2021-12-11,Chicago Bulls,92,Miami Heat,118,26,1,0
2709,2021-12-11,Golden State Warriors,93,Philadelphia 76ers,102,9,1,0
2710,2021-12-11,Denver Nuggets,127,San Antonio Spurs,112,-15,0,1
2711,2021-12-12,Milwaukee Bucks,112,New York Knicks,97,-15,0,1
2712,2021-12-12,Brooklyn Nets,116,Detroit Pistons,104,-12,0,1
2713,2021-12-12,Dallas Mavericks,103,Oklahoma City Thunder,84,-19,0,1
2714,2021-12-12,New Orleans Pelicans,97,San Antonio Spurs,112,15,1,0
2715,2021-12-12,Minnesota Timberwolves,116,Portland Trail Blazers,111,-5,0,1
2716,2021-12-12,Orlando Magic,94,Los Angeles Lakers,106,12,1,0
2717,2021-12-13,Miami Heat,94,Cleveland Cavaliers,105,11,1,0
2718,2021-12-13,Golden State Warriors,102,Indiana Pacers,100,-2,0,1
2719,2021-12-13,Sacramento Kings,101,Toronto Raptors,124,23,1,0
2720,2021-12-13,Houston Rockets,132,Atlanta Hawks,126,-6,0,1
2721,2021-12-13,Milwaukee Bucks,103,Boston Celtics,117,14,1,0
2722,2021-12-13,Philadelphia 76ers,91,Memphis Grizzlies,126,35,1,0
2723,2021-12-13,Charlotte Hornets,96,Dallas Mavericks,120,24,1,0
2724,2021-12-13,Washington Wizards,107,Denver Nuggets,113,6,1,0
2725,2021-12-13,Phoenix Suns,95,Los Angeles Clippers,111,16,1,0
2726,2021-12-14,Toronto Raptors,129,Brooklyn Nets,131,2,1,0
2727,2021-12-14,Golden State Warriors,105,New York Knicks,96,-9,0,1
2728,2021-12-14,Phoenix Suns,111,Portland Trail Blazers,107,-4,0,1
2729,2021-12-15,Houston Rockets,89,Cleveland Cavaliers,124,35,1,0
2730,2021-12-15,Atlanta Hawks,111,Orlando Magic,99,-12,0,1
2731,2021-12-15,Miami Heat,101,Philadelphia 76ers,96,-5,0,1
2732,2021-12-15,Los Angeles Lakers,107,Dallas Mavericks,104,-3,0,1
2733,2021-12-15,Indiana Pacers,99,Milwaukee Bucks,114,15,1,0
2734,2021-12-15,New Orleans Pelicans,113,Oklahoma City Thunder,110,-3,0,1
2735,2021-12-15,Charlotte Hornets,131,San Antonio Spurs,115,-16,0,1
2736,2021-12-15,Minnesota Timberwolves,124,Denver Nuggets,107,-17,0,1
2737,2021-12-15,Memphis Grizzlies,113,Portland Trail Blazers,103,-10,0,1
2738,2021-12-15,Washington Wizards,105,Sacramento Kings,119,14,1,0
2739,2021-12-15,Los Angeles Clippers,103,Utah Jazz,124,21,1,0
2740,2021-12-16,Detroit Pistons,113,Indiana Pacers,122,9,1,0
2741,2021-12-16,Philadelphia 76ers,105,Brooklyn Nets,114,9,1,0
2742,2021-12-16,New York Knicks,116,Houston Rockets,103,-13,0,1
2743,2021-12-16,Washington Wizards,98,Phoenix Suns,118,20,1,0
2744,2021-12-17,Miami Heat,115,Orlando Magic,105,-10,0,1
2745,2021-12-17,Denver Nuggets,133,Atlanta Hawks,115,-18,0,1
2746,2021-12-17,Golden State Warriors,111,Boston Celtics,107,-4,0,1
2747,2021-12-17,Milwaukee Bucks,112,New Orleans Pelicans,116,4,1,0
2748,2021-12-17,San Antonio Spurs,128,Utah Jazz,126,-2,0,1
2749,2021-12-17,Los Angeles Lakers,92,Minnesota Timberwolves,110,18,1,0
2750,2021-12-17,Charlotte Hornets,116,Portland Trail Blazers,125,9,1,0
2751,2021-12-17,Memphis Grizzlies,124,Sacramento Kings,105,-19,0,1
2752,2021-12-18,Houston Rockets,116,Detroit Pistons,107,-9,0,1
2753,2021-12-18,New York Knicks,107,Boston Celtics,114,7,1,0
2754,2021-12-18,Orlando Magic,100,Brooklyn Nets,93,-7,0,1
2755,2021-12-18,Golden State Warriors,100,Toronto Raptors,119,19,1,0
2756,2021-12-18,Los Angeles Clippers,103,Oklahoma City Thunder,104,1,1,0
2757,2021-12-18,Cleveland Cavaliers,119,Milwaukee Bucks,90,-29,0,1
2758,2021-12-18,Washington Wizards,109,Utah Jazz,103,-6,0,1
2759,2021-12-19,Miami Heat,90,Detroit Pistons,100,10,1,0
2760,2021-12-19,Portland Trail Blazers,105,Memphis Grizzlies,100,-5,0,1
2761,2021-12-19,San Antonio Spurs,114,Sacramento Kings,121,7,1,0
2762,2021-12-19,Los Angeles Lakers,110,Chicago Bulls,115,5,1,0
2763,2021-12-19,Dallas Mavericks,105,Minnesota Timberwolves,111,6,1,0
2764,2021-12-19,Charlotte Hornets,106,Phoenix Suns,137,31,1,0
2765,2021-12-20,Philadelphia 76ers,108,Boston Celtics,103,-5,0,1
2766,2021-12-20,Houston Rockets,118,Chicago Bulls,133,15,1,0
2767,2021-12-20,Oklahoma City Thunder,102,Memphis Grizzlies,99,-3,0,1
2768,2021-12-20,Charlotte Hornets,102,Utah Jazz,112,10,1,0
2769,2021-12-20,Sacramento Kings,98,Golden State Warriors,113,15,1,0
2770,2021-12-20,San Antonio Spurs,116,Los Angeles Clippers,92,-24,0,1
2771,2021-12-21,Indiana Pacers,96,Miami Heat,125,29,1,0
2772,2021-12-21,Detroit Pistons,91,New York Knicks,105,14,1,0
2773,2021-12-21,Portland Trail Blazers,97,New Orleans Pelicans,111,14,1,0
2774,2021-12-21,Minnesota Timberwolves,102,Dallas Mavericks,114,12,1,0
2775,2021-12-21,Phoenix Suns,108,Los Angeles Lakers,90,-18,0,1
2776,2021-12-22,Orlando Magic,104,Atlanta Hawks,98,-6,0,1
2777,2021-12-22,Cleveland Cavaliers,101,Boston Celtics,111,10,1,0
2778,2021-12-22,Houston Rockets,106,Milwaukee Bucks,126,20,1,0
2779,2021-12-22,Denver Nuggets,94,Oklahoma City Thunder,108,14,1,0
2780,2021-12-22,Los Angeles Clippers,105,Sacramento Kings,89,-16,0,1
2781,2021-12-23,Houston Rockets,106,Indiana Pacers,118,12,1,0
2782,2021-12-23,New Orleans Pelicans,110,Orlando Magic,104,-6,0,1
2783,2021-12-23,Atlanta Hawks,98,Philadelphia 76ers,96,-2,0,1
2784,2021-12-23,Detroit Pistons,112,Miami Heat,115,3,1,0
2785,2021-12-23,Washington Wizards,124,New York Knicks,117,-7,0,1
2786,2021-12-23,Milwaukee Bucks,102,Dallas Mavericks,95,-7,0,1
2787,2021-12-23,Charlotte Hornets,115,Denver Nuggets,107,-8,0,1
2788,2021-12-23,Oklahoma City Thunder,101,Phoenix Suns,113,12,1,0
2789,2021-12-23,Minnesota Timberwolves,116,Utah Jazz,128,12,1,0
2790,2021-12-23,Memphis Grizzlies,104,Golden State Warriors,113,9,1,0
2791,2021-12-23,San Antonio Spurs,138,Los Angeles Lakers,110,-28,0,1
2792,2021-12-25,Atlanta Hawks,87,New York Knicks,101,14,1,0
2793,2021-12-25,Boston Celtics,113,Milwaukee Bucks,117,4,1,0
2794,2021-12-25,Golden State Warriors,116,Phoenix Suns,107,-9,0,1
2795,2021-12-25,Brooklyn Nets,122,Los Angeles Lakers,115,-7,0,1
2796,2021-12-25,Dallas Mavericks,116,Utah Jazz,120,4,1,0
2797,2021-12-26,Orlando Magic,83,Miami Heat,93,10,1,0
2798,2021-12-26,Toronto Raptors,99,Cleveland Cavaliers,144,45,1,0
2799,2021-12-26,Memphis Grizzlies,127,Sacramento Kings,102,-25,0,1
2800,2021-12-26,Philadelphia 76ers,117,Washington Wizards,96,-21,0,1
2801,2021-12-26,New Orleans Pelicans,112,Oklahoma City Thunder,117,5,1,0
2802,2021-12-26,Detroit Pistons,109,San Antonio Spurs,144,35,1,0
2803,2021-12-26,Indiana Pacers,105,Chicago Bulls,113,8,1,0
2804,2021-12-26,Denver Nuggets,103,Los Angeles Clippers,100,-3,0,1
2805,2021-12-27,Houston Rockets,99,Charlotte Hornets,123,24,1,0
2806,2021-12-27,Chicago Bulls,130,Atlanta Hawks,118,-12,0,1
2807,2021-12-27,Boston Celtics,103,Minnesota Timberwolves,108,5,1,0
2808,2021-12-27,Utah Jazz,110,San Antonio Spurs,104,-6,0,1
2809,2021-12-27,Memphis Grizzlies,114,Phoenix Suns,113,-1,0,1
2810,2021-12-27,Dallas Mavericks,132,Portland Trail Blazers,117,-15,0,1
2811,2021-12-27,Brooklyn Nets,124,Los Angeles Clippers,108,-16,0,1
2812,2021-12-28,Milwaukee Bucks,127,Orlando Magic,110,-17,0,1
2813,2021-12-28,Washington Wizards,112,Miami Heat,119,7,1,0
2814,2021-12-28,Philadelphia 76ers,114,Toronto Raptors,109,-5,0,1
2815,2021-12-28,Los Angeles Lakers,132,Houston Rockets,123,-9,0,1
2816,2021-12-28,New York Knicks,96,Minnesota Timberwolves,88,-8,0,1
2817,2021-12-28,Cleveland Cavaliers,104,New Orleans Pelicans,108,4,1,0
2818,2021-12-28,Denver Nuggets,89,Golden State Warriors,86,-3,0,1
2819,2021-12-28,Oklahoma City Thunder,111,Sacramento Kings,117,6,1,0
2820,2021-12-29,New York Knicks,94,Detroit Pistons,85,-9,0,1
2821,2021-12-29,Charlotte Hornets,116,Indiana Pacers,108,-8,0,1
2822,2021-12-29,Los Angeles Clippers,91,Boston Celtics,82,-9,0,1
2823,2021-12-29,Atlanta Hawks,117,Chicago Bulls,131,14,1,0
2824,2021-12-29,Los Angeles Lakers,99,Memphis Grizzlies,104,5,1,0
2825,2021-12-29,Oklahoma City Thunder,97,Phoenix Suns,115,18,1,0
2826,2021-12-29,Utah Jazz,120,Portland Trail Blazers,105,-15,0,1
2827,2021-12-29,Dallas Mavericks,94,Sacramento Kings,95,1,1,0
2828,2021-12-30,Philadelphia 76ers,110,Brooklyn Nets,102,-8,0,1
2829,2021-12-30,Milwaukee Bucks,136,Orlando Magic,118,-18,0,1
2830,2021-12-30,Cleveland Cavaliers,93,Washington Wizards,110,17,1,0
2831,2021-12-31,Phoenix Suns,108,Boston Celtics,123,15,1,0
2832,2021-12-31,Chicago Bulls,108,Indiana Pacers,106,-2,0,1
2833,2021-12-31,Dallas Mavericks,112,Sacramento Kings,96,-16,0,1
2834,2021-12-31,Miami Heat,120,Houston Rockets,110,-10,0,1
2835,2021-12-31,Atlanta Hawks,121,Cleveland Cavaliers,118,-3,0,1
2836,2021-12-31,Los Angeles Clippers,108,Toronto Raptors,116,8,1,0
2837,2021-12-31,San Antonio Spurs,105,Memphis Grizzlies,118,13,1,0
2838,2021-12-31,New York Knicks,80,Oklahoma City Thunder,95,15,1,0
2839,2021-12-31,Minnesota Timberwolves,108,Utah Jazz,120,12,1,0
2840,2021-12-31,Portland Trail Blazers,106,Los Angeles Lakers,139,33,1,0
2841,2022-01-01,New Orleans Pelicans,113,Milwaukee Bucks,136,23,1,0
2842,2022-01-01,San Antonio Spurs,116,Detroit Pistons,117,1,1,0
2843,2022-01-01,Chicago Bulls,120,Washington Wizards,119,-1,0,1
2844,2022-01-01,Los Angeles Clippers,120,Brooklyn Nets,116,-4,0,1
2845,2022-01-01,Denver Nuggets,124,Houston Rockets,111,-13,0,1
2846,2022-01-01,Golden State Warriors,123,Utah Jazz,116,-7,0,1
2847,2022-01-02,New York Knicks,105,Toronto Raptors,120,15,1,0
2848,2022-01-02,Orlando Magic,111,Boston Celtics,116,5,1,0
2849,2022-01-02,Indiana Pacers,104,Cleveland Cavaliers,108,4,1,0
2850,2022-01-02,Miami Heat,113,Sacramento Kings,115,2,1,0
2851,2022-01-02,Phoenix Suns,133,Charlotte Hornets,99,-34,0,1
2852,2022-01-02,Dallas Mavericks,95,Oklahoma City Thunder,86,-9,0,1
2853,2022-01-02,Minnesota Timberwolves,103,Los Angeles Lakers,108,5,1,0
2854,2022-01-03,Houston Rockets,113,Philadelphia 76ers,133,20,1,0
2855,2022-01-03,Charlotte Hornets,121,Washington Wizards,124,3,1,0
2856,2022-01-03,Memphis Grizzlies,118,Brooklyn Nets,104,-14,0,1
2857,2022-01-03,Orlando Magic,98,Chicago Bulls,102,4,1,0
2858,2022-01-03,Detroit Pistons,115,Milwaukee Bucks,106,-9,0,1
2859,2022-01-03,Utah Jazz,115,New Orleans Pelicans,104,-11,0,1
2860,2022-01-03,Denver Nuggets,89,Dallas Mavericks,103,14,1,0
2861,2022-01-03,Miami Heat,108,Golden State Warriors,115,7,1,0
2862,2022-01-03,Atlanta Hawks,131,Portland Trail Blazers,136,5,1,0
2863,2022-01-03,Minnesota Timberwolves,122,Los Angeles Clippers,104,-18,0,1
2864,2022-01-04,Memphis Grizzlies,110,Cleveland Cavaliers,106,-4,0,1
2865,2022-01-04,San Antonio Spurs,104,Toronto Raptors,129,25,1,0
2866,2022-01-04,Indiana Pacers,94,New York Knicks,104,10,1,0
2867,2022-01-04,Phoenix Suns,123,New Orleans Pelicans,110,-13,0,1
2868,2022-01-04,Sacramento Kings,114,Los Angeles Lakers,122,8,1,0
2869,2022-01-05,Detroit Pistons,111,Charlotte Hornets,140,29,1,0
2870,2022-01-05,Philadelphia 76ers,116,Orlando Magic,106,-10,0,1
2871,2022-01-05,Houston Rockets,114,Washington Wizards,111,-3,0,1
2872,2022-01-05,San Antonio Spurs,99,Boston Celtics,97,-2,0,1
2873,2022-01-05,Golden State Warriors,82,Dallas Mavericks,99,17,1,0
2874,2022-01-05,Brooklyn Nets,129,Indiana Pacers,121,-8,0,1
2875,2022-01-05,Toronto Raptors,117,Milwaukee Bucks,111,-6,0,1
2876,2022-01-05,Oklahoma City Thunder,90,Minnesota Timberwolves,98,8,1,0
2877,2022-01-05,Utah Jazz,115,Denver Nuggets,109,-6,0,1
2878,2022-01-05,Miami Heat,115,Portland Trail Blazers,109,-6,0,1
2879,2022-01-05,Atlanta Hawks,108,Sacramento Kings,102,-6,0,1
2880,2022-01-06,Boston Celtics,105,New York Knicks,108,3,1,0
2881,2022-01-06,Detroit Pistons,88,Memphis Grizzlies,118,30,1,0
2882,2022-01-06,Golden State Warriors,96,New Orleans Pelicans,101,5,1,0
2883,2022-01-06,Los Angeles Clippers,89,Phoenix Suns,106,17,1,0
2884,2022-01-07,San Antonio Spurs,100,Philadelphia 76ers,119,19,1,0
2885,2022-01-07,Milwaukee Bucks,121,Brooklyn Nets,109,-12,0,1
2886,2022-01-07,Utah Jazz,108,Toronto Raptors,122,14,1,0
2887,2022-01-07,Washington Wizards,122,Chicago Bulls,130,8,1,0
2888,2022-01-07,Dallas Mavericks,130,Houston Rockets,106,-24,0,1
2889,2022-01-07,Minnesota Timberwolves,135,Oklahoma City Thunder,105,-30,0,1
2890,2022-01-07,Sacramento Kings,111,Denver Nuggets,121,10,1,0
2891,2022-01-07,Atlanta Hawks,118,Los Angeles Lakers,134,16,1,0
2892,2022-01-07,Cleveland Cavaliers,114,Portland Trail Blazers,101,-13,0,1
2893,2022-01-08,Memphis Grizzlies,123,Los Angeles Clippers,108,-15,0,1
2894,2022-01-08,Milwaukee Bucks,106,Charlotte Hornets,114,8,1,0
2895,2022-01-08,Orlando Magic,92,Detroit Pistons,97,5,1,0
2896,2022-01-08,Utah Jazz,113,Indiana Pacers,125,12,1,0
2897,2022-01-08,New York Knicks,75,Boston Celtics,99,24,1,0
2898,2022-01-08,Miami Heat,123,Phoenix Suns,100,-23,0,1
2899,2022-01-09,San Antonio Spurs,119,Brooklyn Nets,121,2,1,0
2900,2022-01-09,Atlanta Hawks,93,Los Angeles Clippers,106,13,1,0
2901,2022-01-09,Washington Wizards,102,Orlando Magic,100,-2,0,1
2902,2022-01-09,New Orleans Pelicans,101,Toronto Raptors,105,4,1,0
2903,2022-01-09,Minnesota Timberwolves,141,Houston Rockets,123,-18,0,1
2904,2022-01-09,Denver Nuggets,99,Oklahoma City Thunder,95,-4,0,1
2905,2022-01-09,Chicago Bulls,99,Dallas Mavericks,113,14,1,0
2906,2022-01-09,Cleveland Cavaliers,82,Golden State Warriors,96,14,1,0
2907,2022-01-09,Sacramento Kings,88,Portland Trail Blazers,103,15,1,0
2908,2022-01-09,Memphis Grizzlies,127,Los Angeles Lakers,119,-8,0,1
2909,2022-01-10,Milwaukee Bucks,99,Charlotte Hornets,103,4,1,0
2910,2022-01-10,Utah Jazz,116,Detroit Pistons,126,10,1,0
2911,2022-01-10,Indiana Pacers,98,Boston Celtics,101,3,1,0
2912,2022-01-10,San Antonio Spurs,96,New York Knicks,111,15,1,0
2913,2022-01-10,Philadelphia 76ers,111,Houston Rockets,91,-20,0,1
2914,2022-01-10,Brooklyn Nets,108,Portland Trail Blazers,114,6,1,0
2915,2022-01-10,Cleveland Cavaliers,109,Sacramento Kings,108,-1,0,1
2916,2022-01-11,Oklahoma City Thunder,118,Washington Wizards,122,4,1,0
2917,2022-01-11,Phoenix Suns,99,Toronto Raptors,95,-4,0,1
2918,2022-01-11,Detroit Pistons,87,Chicago Bulls,133,46,1,0
2919,2022-01-11,Golden State Warriors,108,Memphis Grizzlies,116,8,1,0
2920,2022-01-11,Minnesota Timberwolves,125,New Orleans Pelicans,128,3,1,0
2921,2022-01-11,Denver Nuggets,85,Los Angeles Clippers,87,2,1,0
2922,2022-01-12,Boston Celtics,119,Indiana Pacers,100,-19,0,1
2923,2022-01-12,Charlotte Hornets,109,Philadelphia 76ers,98,-11,0,1
2924,2022-01-12,Orlando Magic,106,Washington Wizards,112,6,1,0
2925,2022-01-12,Miami Heat,115,Atlanta Hawks,91,-24,0,1
2926,2022-01-12,Dallas Mavericks,85,New York Knicks,108,23,1,0
2927,2022-01-12,Houston Rockets,128,San Antonio Spurs,124,-4,0,1
2928,2022-01-12,Cleveland Cavaliers,111,Utah Jazz,91,-20,0,1
2929,2022-01-12,Brooklyn Nets,138,Chicago Bulls,112,-26,0,1
2930,2022-01-12,Los Angeles Lakers,116,Sacramento Kings,125,9,1,0
2931,2022-01-13,Golden State Warriors,99,Milwaukee Bucks,118,19,1,0
2932,2022-01-13,Minnesota Timberwolves,108,Memphis Grizzlies,116,8,1,0
2933,2022-01-13,Los Angeles Clippers,89,New Orleans Pelicans,113,24,1,0
2934,2022-01-13,Oklahoma City Thunder,130,Brooklyn Nets,109,-21,0,1
2935,2022-01-13,Portland Trail Blazers,108,Denver Nuggets,140,32,1,0
2936,2022-01-14,Orlando Magic,116,Charlotte Hornets,109,-7,0,1
2937,2022-01-14,Toronto Raptors,87,Detroit Pistons,103,16,1,0
2938,2022-01-14,Phoenix Suns,112,Indiana Pacers,94,-18,0,1
2939,2022-01-14,Boston Celtics,99,Philadelphia 76ers,111,12,1,0
2940,2022-01-14,Golden State Warriors,138,Chicago Bulls,96,-42,0,1
2941,2022-01-14,Atlanta Hawks,118,Miami Heat,124,6,1,0
2942,2022-01-14,Cleveland Cavaliers,114,San Antonio Spurs,109,-5,0,1
2943,2022-01-14,Dallas Mavericks,112,Memphis Grizzlies,85,-27,0,1
2944,2022-01-14,Houston Rockets,114,Sacramento Kings,126,12,1,0
2945,2022-01-15,Toronto Raptors,103,Milwaukee Bucks,96,-7,0,1
2946,2022-01-15,Portland Trail Blazers,115,Washington Wizards,110,-5,0,1
2947,2022-01-15,New York Knicks,117,Atlanta Hawks,108,-9,0,1
2948,2022-01-15,New Orleans Pelicans,105,Brooklyn Nets,120,15,1,0
2949,2022-01-15,Philadelphia 76ers,109,Miami Heat,98,-11,0,1
2950,2022-01-15,Cleveland Cavaliers,107,Oklahoma City Thunder,102,-5,0,1
2951,2022-01-15,Chicago Bulls,112,Boston Celtics,114,2,1,0
2952,2022-01-15,Los Angeles Clippers,94,San Antonio Spurs,101,7,1,0
2953,2022-01-15,Los Angeles Lakers,96,Denver Nuggets,133,37,1,0
2954,2022-01-15,Orlando Magic,92,Dallas Mavericks,108,16,1,0
2955,2022-01-16,Phoenix Suns,135,Detroit Pistons,108,-27,0,1
2956,2022-01-16,Houston Rockets,118,Sacramento Kings,112,-6,0,1
2957,2022-01-16,Utah Jazz,125,Denver Nuggets,102,-23,0,1
2958,2022-01-16,Golden State Warriors,99,Minnesota Timberwolves,119,20,1,0
2959,2022-01-17,New Orleans Pelicans,92,Boston Celtics,104,12,1,0
2960,2022-01-17,Charlotte Hornets,97,New York Knicks,87,-10,0,1
2961,2022-01-17,Philadelphia 76ers,98,Washington Wizards,117,19,1,0
2962,2022-01-17,Brooklyn Nets,107,Cleveland Cavaliers,114,7,1,0
2963,2022-01-17,Indiana Pacers,133,Los Angeles Clippers,139,6,1,0
2964,2022-01-17,Chicago Bulls,106,Memphis Grizzlies,119,13,1,0
2965,2022-01-17,Milwaukee Bucks,114,Atlanta Hawks,121,7,1,0
2966,2022-01-17,Portland Trail Blazers,98,Orlando Magic,88,-10,0,1
2967,2022-01-17,Toronto Raptors,99,Miami Heat,104,5,1,0
2968,2022-01-17,Oklahoma City Thunder,102,Dallas Mavericks,104,2,1,0
2969,2022-01-17,Phoenix Suns,121,San Antonio Spurs,107,-14,0,1
2970,2022-01-17,Utah Jazz,95,Los Angeles Lakers,101,6,1,0
2971,2022-01-18,Minnesota Timberwolves,112,New York Knicks,110,-2,0,1
2972,2022-01-18,Detroit Pistons,86,Golden State Warriors,102,16,1,0
2973,2022-01-19,Orlando Magic,110,Philadelphia 76ers,123,13,1,0
2974,2022-01-19,Brooklyn Nets,119,Washington Wizards,118,-1,0,1
2975,2022-01-19,Minnesota Timberwolves,122,Atlanta Hawks,134,12,1,0
2976,2022-01-19,Charlotte Hornets,111,Boston Celtics,102,-9,0,1
2977,2022-01-19,Portland Trail Blazers,92,Miami Heat,104,12,1,0
2978,2022-01-19,Cleveland Cavaliers,104,Chicago Bulls,117,13,1,0
2979,2022-01-19,Memphis Grizzlies,114,Milwaukee Bucks,126,12,1,0
2980,2022-01-19,Toronto Raptors,98,Dallas Mavericks,102,4,1,0
2981,2022-01-19,Oklahoma City Thunder,96,San Antonio Spurs,118,22,1,0
2982,2022-01-19,Houston Rockets,116,Utah Jazz,111,-5,0,1
2983,2022-01-19,Los Angeles Clippers,128,Denver Nuggets,130,2,1,0
2984,2022-01-19,Detroit Pistons,133,Sacramento Kings,131,-2,0,1
2985,2022-01-19,Indiana Pacers,111,Los Angeles Lakers,104,-7,0,1
2986,2022-01-20,Phoenix Suns,109,Dallas Mavericks,101,-8,0,1
2987,2022-01-20,New Orleans Pelicans,102,New York Knicks,91,-11,0,1
2988,2022-01-20,Indiana Pacers,121,Golden State Warriors,117,-4,0,1
2989,2022-01-21,Oklahoma City Thunder,98,Charlotte Hornets,121,23,1,0
2990,2022-01-21,Los Angeles Lakers,116,Orlando Magic,105,-11,0,1
2991,2022-01-21,Los Angeles Clippers,102,Philadelphia 76ers,101,-1,0,1
2992,2022-01-21,Miami Heat,108,Atlanta Hawks,110,2,1,0
2993,2022-01-21,Portland Trail Blazers,109,Boston Celtics,105,-4,0,1
2994,2022-01-21,Chicago Bulls,90,Milwaukee Bucks,94,4,1,0
2995,2022-01-21,Toronto Raptors,109,Washington Wizards,105,-4,0,1
2996,2022-01-21,Brooklyn Nets,117,San Antonio Spurs,102,-15,0,1
2997,2022-01-21,Memphis Grizzlies,122,Denver Nuggets,118,-4,0,1
2998,2022-01-21,Detroit Pistons,101,Utah Jazz,111,10,1,0
2999,2022-01-21,Houston Rockets,103,Golden State Warriors,105,2,1,0
3000,2022-01-22,Sacramento Kings,127,Milwaukee Bucks,133,6,1,0
3001,2022-01-22,Oklahoma City Thunder,87,Cleveland Cavaliers,94,7,1,0
3002,2022-01-22,Indiana Pacers,103,Phoenix Suns,113,10,1,0
3003,2022-01-23,Los Angeles Clippers,102,New York Knicks,110,8,1,0
3004,2022-01-23,Boston Celtics,116,Washington Wizards,87,-29,0,1
3005,2022-01-23,Los Angeles Lakers,107,Miami Heat,113,6,1,0
3006,2022-01-23,Chicago Bulls,95,Orlando Magic,114,19,1,0
3007,2022-01-23,Portland Trail Blazers,114,Toronto Raptors,105,-9,0,1
3008,2022-01-23,Atlanta Hawks,113,Charlotte Hornets,91,-22,0,1
3009,2022-01-23,Philadelphia 76ers,115,San Antonio Spurs,109,-6,0,1
3010,2022-01-23,Memphis Grizzlies,91,Dallas Mavericks,104,13,1,0
3011,2022-01-23,Detroit Pistons,111,Denver Nuggets,117,6,1,0
3012,2022-01-23,Brooklyn Nets,125,Minnesota Timberwolves,136,11,1,0
3013,2022-01-23,Utah Jazz,92,Golden State Warriors,94,2,1,0
3014,2022-01-24,New York Knicks,93,Cleveland Cavaliers,95,2,1,0
3015,2022-01-24,Indiana Pacers,113,New Orleans Pelicans,117,4,1,0
3016,2022-01-24,Chicago Bulls,111,Oklahoma City Thunder,110,-1,0,1
3017,2022-01-24,Utah Jazz,109,Phoenix Suns,115,6,1,0
3018,2022-01-25,Denver Nuggets,110,Detroit Pistons,105,-5,0,1
3019,2022-01-25,New Orleans Pelicans,107,Philadelphia 76ers,117,10,1,0
3020,2022-01-25,Charlotte Hornets,113,Toronto Raptors,125,12,1,0
3021,2022-01-25,Los Angeles Clippers,116,Washington Wizards,115,-1,0,1
3022,2022-01-25,Sacramento Kings,75,Boston Celtics,128,53,1,0
3023,2022-01-25,Los Angeles Lakers,106,Brooklyn Nets,96,-10,0,1
3024,2022-01-25,San Antonio Spurs,134,Houston Rockets,104,-30,0,1
3025,2022-01-25,Dallas Mavericks,92,Golden State Warriors,130,38,1,0
3026,2022-01-25,Minnesota Timberwolves,109,Portland Trail Blazers,107,-2,0,1
3027,2022-01-26,Milwaukee Bucks,99,Cleveland Cavaliers,115,16,1,0
3028,2022-01-26,Charlotte Hornets,158,Indiana Pacers,126,-32,0,1
3029,2022-01-26,Los Angeles Clippers,111,Orlando Magic,102,-9,0,1
3030,2022-01-26,Sacramento Kings,104,Atlanta Hawks,121,17,1,0
3031,2022-01-26,New York Knicks,96,Miami Heat,110,14,1,0
3032,2022-01-26,Denver Nuggets,124,Brooklyn Nets,118,-6,0,1
3033,2022-01-26,Toronto Raptors,105,Chicago Bulls,111,6,1,0
3034,2022-01-26,Memphis Grizzlies,118,San Antonio Spurs,110,-8,0,1
3035,2022-01-26,Dallas Mavericks,132,Portland Trail Blazers,112,-20,0,1
3036,2022-01-26,Phoenix Suns,105,Utah Jazz,97,-8,0,1
3037,2022-01-27,Los Angeles Lakers,87,Philadelphia 76ers,105,18,1,0
3038,2022-01-27,Minnesota Timberwolves,115,Golden State Warriors,124,9,1,0
3039,2022-01-28,Detroit Pistons,103,Orlando Magic,119,16,1,0
3040,2022-01-28,Boston Celtics,92,Atlanta Hawks,108,16,1,0
3041,2022-01-28,Los Angeles Lakers,114,Charlotte Hornets,117,3,1,0
3042,2022-01-28,Portland Trail Blazers,125,Houston Rockets,110,-15,0,1
3043,2022-01-28,Utah Jazz,109,Memphis Grizzlies,119,10,1,0
3044,2022-01-28,Los Angeles Clippers,114,Miami Heat,121,7,1,0
3045,2022-01-28,Denver Nuggets,116,New Orleans Pelicans,105,-11,0,1
3046,2022-01-28,Indiana Pacers,113,Oklahoma City Thunder,110,-3,0,1
3047,2022-01-28,Chicago Bulls,122,San Antonio Spurs,131,9,1,0
3048,2022-01-28,Minnesota Timberwolves,124,Phoenix Suns,134,10,1,0
3049,2022-01-28,New York Knicks,108,Milwaukee Bucks,123,15,1,0
3050,2022-01-29,Indiana Pacers,105,Dallas Mavericks,132,27,1,0
3051,2022-01-29,Boston Celtics,107,New Orleans Pelicans,97,-10,0,1
3052,2022-01-29,Sacramento Kings,101,Philadelphia 76ers,103,2,1,0
3053,2022-01-29,Washington Wizards,95,Memphis Grizzlies,115,20,1,0
3054,2022-01-29,Toronto Raptors,124,Miami Heat,120,-4,0,1
3055,2022-01-29,Brooklyn Nets,106,Golden State Warriors,110,4,1,0
3056,2022-01-30,Los Angeles Lakers,121,Atlanta Hawks,129,8,1,0
3057,2022-01-30,Los Angeles Clippers,115,Charlotte Hornets,90,-25,0,1
3058,2022-01-30,Portland Trail Blazers,116,Chicago Bulls,130,14,1,0
3059,2022-01-30,Cleveland Cavaliers,105,Detroit Pistons,115,10,1,0
3060,2022-01-30,Denver Nuggets,136,Milwaukee Bucks,100,-36,0,1
3061,2022-01-30,Dallas Mavericks,108,Orlando Magic,110,2,1,0
3062,2022-01-30,Utah Jazz,106,Minnesota Timberwolves,126,20,1,0
3063,2022-01-30,San Antonio Spurs,110,Phoenix Suns,115,5,1,0
3064,2022-01-31,New Orleans Pelicans,90,Cleveland Cavaliers,93,3,1,0
3065,2022-01-31,Los Angeles Clippers,116,Indiana Pacers,122,6,1,0
3066,2022-01-31,Memphis Grizzlies,119,Philadelphia 76ers,122,3,1,0
3067,2022-01-31,Toronto Raptors,106,Atlanta Hawks,100,-6,0,1
3068,2022-01-31,Miami Heat,92,Boston Celtics,122,30,1,0
3069,2022-01-31,Sacramento Kings,96,New York Knicks,116,20,1,0
3070,2022-01-31,Golden State Warriors,122,Houston Rockets,108,-14,0,1
3071,2022-01-31,Portland Trail Blazers,81,Oklahoma City Thunder,98,17,1,0
3072,2022-02-01,New Orleans Pelicans,111,Detroit Pistons,101,-10,0,1
3073,2022-02-01,Washington Wizards,98,Milwaukee Bucks,112,14,1,0
3074,2022-02-01,Miami Heat,106,Toronto Raptors,110,4,1,0
3075,2022-02-01,Orlando Magic,115,Chicago Bulls,126,11,1,0
3076,2022-02-01,Denver Nuggets,115,Minnesota Timberwolves,130,15,1,0
3077,2022-02-01,Golden State Warriors,124,San Antonio Spurs,120,-4,0,1
3078,2022-02-01,Brooklyn Nets,111,Phoenix Suns,121,10,1,0
3079,2022-02-02,Orlando Magic,119,Indiana Pacers,118,-1,0,1
3080,2022-02-02,Washington Wizards,106,Philadelphia 76ers,103,-3,0,1
3081,2022-02-02,Charlotte Hornets,107,Boston Celtics,113,6,1,0
3082,2022-02-02,Memphis Grizzlies,120,New York Knicks,108,-12,0,1
3083,2022-02-02,Cleveland Cavaliers,104,Houston Rockets,115,11,1,0
3084,2022-02-02,Oklahoma City Thunder,120,Dallas Mavericks,114,-6,0,1
3085,2022-02-02,Brooklyn Nets,101,Sacramento Kings,112,11,1,0
3086,2022-02-02,Denver Nuggets,104,Utah Jazz,108,4,1,0
3087,2022-02-02,Portland Trail Blazers,94,Los Angeles Lakers,99,5,1,0
3088,2022-02-03,Minnesota Timberwolves,128,Detroit Pistons,117,-11,0,1
3089,2022-02-03,Miami Heat,112,San Antonio Spurs,95,-17,0,1
3090,2022-02-03,Phoenix Suns,115,Atlanta Hawks,124,9,1,0
3091,2022-02-03,Chicago Bulls,120,Toronto Raptors,127,7,1,0
3092,2022-02-03,Sacramento Kings,114,Golden State Warriors,126,12,1,0
3093,2022-02-03,Los Angeles Lakers,110,Los Angeles Clippers,111,1,1,0
3094,2022-02-04,Cleveland Cavaliers,102,Charlotte Hornets,101,-1,0,1
3095,2022-02-04,Boston Celtics,102,Detroit Pistons,93,-9,0,1
3096,2022-02-04,Chicago Bulls,122,Indiana Pacers,115,-7,0,1
3097,2022-02-04,Atlanta Hawks,114,Toronto Raptors,125,11,1,0
3098,2022-02-04,Houston Rockets,106,San Antonio Spurs,131,25,1,0
3099,2022-02-04,New Orleans Pelicans,113,Denver Nuggets,105,-8,0,1
3100,2022-02-04,Brooklyn Nets,102,Utah Jazz,125,23,1,0
3101,2022-02-04,Philadelphia 76ers,98,Dallas Mavericks,107,9,1,0
3102,2022-02-04,Oklahoma City Thunder,96,Portland Trail Blazers,93,-3,0,1
3103,2022-02-05,Memphis Grizzlies,135,Orlando Magic,115,-20,0,1
3104,2022-02-05,Miami Heat,104,Charlotte Hornets,86,-18,0,1
3105,2022-02-05,Phoenix Suns,95,Washington Wizards,80,-15,0,1
3106,2022-02-05,New York Knicks,115,Los Angeles Lakers,122,7,1,0
3107,2022-02-05,Milwaukee Bucks,137,Portland Trail Blazers,108,-29,0,1
3108,2022-02-05,Oklahoma City Thunder,103,Sacramento Kings,113,10,1,0
3109,2022-02-06,Philadelphia 76ers,119,Chicago Bulls,108,-11,0,1
3110,2022-02-06,Brooklyn Nets,104,Denver Nuggets,124,20,1,0
3111,2022-02-06,Detroit Pistons,105,Minnesota Timberwolves,118,13,1,0
3112,2022-02-06,Indiana Pacers,85,Cleveland Cavaliers,98,13,1,0
3113,2022-02-06,Atlanta Hawks,94,Dallas Mavericks,103,9,1,0
3114,2022-02-06,Boston Celtics,116,Orlando Magic,83,-33,0,1
3115,2022-02-06,New Orleans Pelicans,120,Houston Rockets,107,-13,0,1
3116,2022-02-06,Milwaukee Bucks,137,Los Angeles Clippers,113,-24,0,1
3117,2022-02-07,Toronto Raptors,116,Charlotte Hornets,101,-15,0,1
3118,2022-02-07,Miami Heat,121,Washington Wizards,100,-21,0,1
3119,2022-02-07,Phoenix Suns,127,Chicago Bulls,124,-3,0,1
3120,2022-02-07,Golden State Warriors,110,Oklahoma City Thunder,98,-12,0,1
3121,2022-02-07,New York Knicks,104,Utah Jazz,113,9,1,0
3122,2022-02-08,Phoenix Suns,114,Philadelphia 76ers,109,-5,0,1
3123,2022-02-08,Indiana Pacers,112,Atlanta Hawks,133,21,1,0
3124,2022-02-08,Boston Celtics,126,Brooklyn Nets,91,-35,0,1
3125,2022-02-08,Los Angeles Clippers,109,Memphis Grizzlies,135,26,1,0
3126,2022-02-08,Houston Rockets,97,New Orleans Pelicans,110,13,1,0
3127,2022-02-08,Detroit Pistons,86,Dallas Mavericks,116,30,1,0
3128,2022-02-08,New York Knicks,115,Denver Nuggets,132,17,1,0
3129,2022-02-08,Milwaukee Bucks,131,Los Angeles Lakers,116,-15,0,1
3130,2022-02-08,Orlando Magic,113,Portland Trail Blazers,95,-18,0,1
3131,2022-02-08,Minnesota Timberwolves,134,Sacramento Kings,114,-20,0,1
3132,2022-02-09,San Antonio Spurs,92,Cleveland Cavaliers,105,13,1,0
3133,2022-02-09,Chicago Bulls,121,Charlotte Hornets,109,-12,0,1
3134,2022-02-09,Toronto Raptors,117,Oklahoma City Thunder,98,-19,0,1
3135,2022-02-09,Los Angeles Lakers,105,Portland Trail Blazers,107,2,1,0
3136,2022-02-09,Minnesota Timberwolves,119,Sacramento Kings,132,13,1,0
3137,2022-02-09,Golden State Warriors,85,Utah Jazz,111,26,1,0
3138,2022-02-10,Memphis Grizzlies,132,Detroit Pistons,107,-25,0,1
3139,2022-02-10,Miami Heat,112,New Orleans Pelicans,97,-15,0,1
3140,2022-02-10,Brooklyn Nets,112,Washington Wizards,113,1,1,0
3141,2022-02-10,Toronto Raptors,139,Houston Rockets,120,-19,0,1
3142,2022-02-10,Los Angeles Clippers,105,Dallas Mavericks,112,7,1,0
3143,2022-02-10,New York Knicks,116,Golden State Warriors,114,-2,0,1
3144,2022-02-10,Milwaukee Bucks,107,Phoenix Suns,131,24,1,0
3145,2022-02-11,Charlotte Hornets,141,Detroit Pistons,119,-22,0,1
3146,2022-02-11,Cleveland Cavaliers,120,Indiana Pacers,113,-7,0,1
3147,2022-02-11,Oklahoma City Thunder,87,Philadelphia 76ers,100,13,1,0
3148,2022-02-11,San Antonio Spurs,136,Atlanta Hawks,121,-15,0,1
3149,2022-02-11,Denver Nuggets,102,Boston Celtics,108,6,1,0
3150,2022-02-11,Minnesota Timberwolves,122,Chicago Bulls,134,12,1,0
3151,2022-02-11,Orlando Magic,99,Utah Jazz,114,15,1,0
3152,2022-02-12,New York Knicks,103,Portland Trail Blazers,112,9,1,0
3153,2022-02-12,Memphis Grizzlies,125,Charlotte Hornets,118,-7,0,1
3154,2022-02-12,San Antonio Spurs,124,New Orleans Pelicans,114,-10,0,1
3155,2022-02-12,Sacramento Kings,123,Washington Wizards,110,-13,0,1
3156,2022-02-12,Cleveland Cavaliers,93,Philadelphia 76ers,103,10,1,0
3157,2022-02-12,Denver Nuggets,110,Toronto Raptors,109,-1,0,1
3158,2022-02-12,Oklahoma City Thunder,101,Chicago Bulls,106,5,1,0
3159,2022-02-12,Brooklyn Nets,111,Miami Heat,115,4,1,0
3160,2022-02-12,Los Angeles Clippers,99,Dallas Mavericks,97,-2,0,1
3161,2022-02-12,Los Angeles Lakers,115,Golden State Warriors,117,2,1,0
3162,2022-02-12,Orlando Magic,105,Phoenix Suns,132,27,1,0
3163,2022-02-13,Atlanta Hawks,95,Boston Celtics,105,10,1,0
3164,2022-02-13,Minnesota Timberwolves,129,Indiana Pacers,120,-9,0,1
3165,2022-02-14,Detroit Pistons,94,Washington Wizards,103,9,1,0
3166,2022-02-14,Sacramento Kings,85,Brooklyn Nets,109,24,1,0
3167,2022-02-14,Oklahoma City Thunder,127,New York Knicks,123,-4,0,1
3168,2022-02-14,San Antonio Spurs,109,Chicago Bulls,120,11,1,0
3169,2022-02-14,Portland Trail Blazers,122,Milwaukee Bucks,107,-15,0,1
3170,2022-02-14,Toronto Raptors,90,New Orleans Pelicans,120,30,1,0
3171,2022-02-14,Orlando Magic,111,Denver Nuggets,121,10,1,0
3172,2022-02-14,Houston Rockets,101,Utah Jazz,135,34,1,0
3173,2022-02-14,Golden State Warriors,104,Los Angeles Clippers,119,15,1,0
3174,2022-02-15,Cleveland Cavaliers,116,Atlanta Hawks,124,8,1,0
3175,2022-02-15,Dallas Mavericks,107,Miami Heat,99,-8,0,1
3176,2022-02-15,Boston Celtics,135,Philadelphia 76ers,87,-48,0,1
3177,2022-02-15,Indiana Pacers,119,Milwaukee Bucks,128,9,1,0
3178,2022-02-15,Charlotte Hornets,120,Minnesota Timberwolves,126,6,1,0
3179,2022-02-15,Memphis Grizzlies,121,New Orleans Pelicans,109,-12,0,1
3180,2022-02-15,Los Angeles Clippers,96,Phoenix Suns,103,7,1,0
3181,2022-02-16,Atlanta Hawks,130,Orlando Magic,109,-21,0,1
3182,2022-02-16,Detroit Pistons,112,Boston Celtics,111,-1,0,1
3183,2022-02-16,Washington Wizards,108,Indiana Pacers,113,5,1,0
3184,2022-02-16,Brooklyn Nets,111,New York Knicks,106,-5,0,1
3185,2022-02-16,Sacramento Kings,118,Chicago Bulls,125,7,1,0
3186,2022-02-16,Portland Trail Blazers,123,Memphis Grizzlies,119,-4,0,1
3187,2022-02-16,Toronto Raptors,103,Minnesota Timberwolves,91,-12,0,1
3188,2022-02-16,San Antonio Spurs,114,Oklahoma City Thunder,106,-8,0,1
3189,2022-02-16,Houston Rockets,121,Phoenix Suns,124,3,1,0
3190,2022-02-16,Denver Nuggets,117,Golden State Warriors,116,-1,0,1
3191,2022-02-16,Utah Jazz,101,Los Angeles Lakers,106,5,1,0
3192,2022-02-17,Miami Heat,111,Charlotte Hornets,107,-4,0,1
3193,2022-02-17,Washington Wizards,117,Brooklyn Nets,103,-14,0,1
3194,2022-02-17,Dallas Mavericks,125,New Orleans Pelicans,118,-7,0,1
3195,2022-02-17,Philadelphia 76ers,123,Milwaukee Bucks,120,-3,0,1
3196,2022-02-17,Houston Rockets,111,Los Angeles Clippers,142,31,1,0
3197,2022-02-24,Cleveland Cavaliers,103,Detroit Pistons,106,3,1,0
3198,2022-02-24,Boston Celtics,129,Brooklyn Nets,106,-23,0,1
3199,2022-02-24,Atlanta Hawks,108,Chicago Bulls,112,4,1,0
3200,2022-02-24,Memphis Grizzlies,114,Minnesota Timberwolves,119,5,1,0
3201,2022-02-24,Phoenix Suns,124,Oklahoma City Thunder,104,-20,0,1
3202,2022-02-24,Golden State Warriors,132,Portland Trail Blazers,95,-37,0,1
3203,2022-02-24,Denver Nuggets,128,Sacramento Kings,110,-18,0,1
3204,2022-02-25,Toronto Raptors,93,Charlotte Hornets,125,32,1,0
3205,2022-02-25,Oklahoma City Thunder,129,Indiana Pacers,125,-4,0,1
3206,2022-02-25,Houston Rockets,111,Orlando Magic,119,8,1,0
3207,2022-02-25,San Antonio Spurs,157,Washington Wizards,153,-4,0,1
3208,2022-02-25,Miami Heat,115,New York Knicks,100,-15,0,1
3209,2022-02-25,Philadelphia 76ers,133,Minnesota Timberwolves,102,-31,0,1
3210,2022-02-25,New Orleans Pelicans,117,Phoenix Suns,102,-15,0,1
3211,2022-02-25,Dallas Mavericks,109,Utah Jazz,114,5,1,0
3212,2022-02-25,Los Angeles Clippers,105,Los Angeles Lakers,102,-3,0,1
3213,2022-02-26,Boston Celtics,113,Detroit Pistons,104,-9,0,1
3214,2022-02-26,Toronto Raptors,100,Atlanta Hawks,127,27,1,0
3215,2022-02-26,Memphis Grizzlies,116,Chicago Bulls,110,-6,0,1
3216,2022-02-26,Washington Wizards,86,Cleveland Cavaliers,92,6,1,0
3217,2022-02-26,San Antonio Spurs,129,Miami Heat,133,4,1,0
3218,2022-02-26,Brooklyn Nets,126,Milwaukee Bucks,123,-3,0,1
3219,2022-02-26,Sacramento Kings,110,Denver Nuggets,115,5,1,0
3220,2022-02-27,Philadelphia 76ers,125,New York Knicks,109,-16,0,1
3221,2022-02-27,Utah Jazz,118,Phoenix Suns,114,-4,0,1
3222,2022-02-27,Boston Celtics,107,Indiana Pacers,128,21,1,0
3223,2022-02-27,Detroit Pistons,127,Charlotte Hornets,126,-1,0,1
3224,2022-02-27,Los Angeles Clippers,99,Houston Rockets,98,-1,0,1
3225,2022-02-27,Dallas Mavericks,107,Golden State Warriors,101,-6,0,1
3226,2022-02-27,Denver Nuggets,124,Portland Trail Blazers,92,-32,0,1
3227,2022-02-27,New Orleans Pelicans,123,Los Angeles Lakers,95,-28,0,1
3228,2022-02-28,Minnesota Timberwolves,127,Cleveland Cavaliers,122,-5,0,1
3229,2022-02-28,Indiana Pacers,103,Orlando Magic,119,16,1,0
3230,2022-02-28,Toronto Raptors,133,Brooklyn Nets,97,-36,0,1
3231,2022-02-28,Chicago Bulls,99,Miami Heat,112,13,1,0
3232,2022-02-28,San Antonio Spurs,105,Memphis Grizzlies,118,13,1,0
3233,2022-02-28,Charlotte Hornets,106,Milwaukee Bucks,130,24,1,0
3234,2022-02-28,Sacramento Kings,131,Oklahoma City Thunder,110,-21,0,1
3235,2022-03-01,Detroit Pistons,113,Washington Wizards,116,3,1,0
3236,2022-03-01,Atlanta Hawks,98,Boston Celtics,107,9,1,0
3237,2022-03-01,Brooklyn Nets,108,Toronto Raptors,109,1,1,0
3238,2022-03-01,Los Angeles Clippers,113,Houston Rockets,100,-13,0,1
3239,2022-03-01,Golden State Warriors,114,Minnesota Timberwolves,129,15,1,0
3240,2022-03-01,Dallas Mavericks,109,Los Angeles Lakers,104,-5,0,1
3241,2022-03-02,Charlotte Hornets,119,Cleveland Cavaliers,98,-21,0,1
3242,2022-03-02,Indiana Pacers,122,Orlando Magic,114,-8,0,1
3243,2022-03-02,New York Knicks,108,Philadelphia 76ers,123,15,1,0
3244,2022-03-02,Utah Jazz,132,Houston Rockets,127,-5,0,1
3245,2022-03-02,Miami Heat,119,Milwaukee Bucks,120,1,1,0
3246,2022-03-02,Sacramento Kings,95,New Orleans Pelicans,125,30,1,0
3247,2022-03-02,Oklahoma City Thunder,119,Denver Nuggets,107,-12,0,1
3248,2022-03-02,Portland Trail Blazers,90,Phoenix Suns,120,30,1,0
3249,2022-03-03,Chicago Bulls,124,Atlanta Hawks,130,6,1,0
3250,2022-03-03,Memphis Grizzlies,107,Boston Celtics,120,13,1,0
3251,2022-03-03,Miami Heat,113,Brooklyn Nets,107,-6,0,1
3252,2022-03-03,Detroit Pistons,108,Toronto Raptors,106,-2,0,1
3253,2022-03-03,Golden State Warriors,113,Dallas Mavericks,122,9,1,0
3254,2022-03-03,Sacramento Kings,115,San Antonio Spurs,112,-3,0,1
3255,2022-03-03,Los Angeles Lakers,111,Los Angeles Clippers,132,21,1,0
3256,2022-03-04,Indiana Pacers,106,Detroit Pistons,111,5,1,0
3257,2022-03-04,Cleveland Cavaliers,119,Philadelphia 76ers,125,6,1,0
3258,2022-03-04,Atlanta Hawks,117,Washington Wizards,114,-3,0,1
3259,2022-03-04,Milwaukee Bucks,118,Chicago Bulls,112,-6,0,1
3260,2022-03-04,Orlando Magic,103,Toronto Raptors,97,-6,0,1
3261,2022-03-04,Utah Jazz,90,New Orleans Pelicans,124,34,1,0
3262,2022-03-04,Minnesota Timberwolves,138,Oklahoma City Thunder,101,-37,0,1
3263,2022-03-04,Houston Rockets,101,Denver Nuggets,116,15,1,0
3264,2022-03-04,New York Knicks,114,Phoenix Suns,115,1,1,0
3265,2022-03-05,Sacramento Kings,113,Dallas Mavericks,114,1,1,0
3266,2022-03-05,San Antonio Spurs,117,Charlotte Hornets,123,6,1,0
3267,2022-03-05,Orlando Magic,96,Memphis Grizzlies,124,28,1,0
3268,2022-03-05,Philadelphia 76ers,82,Miami Heat,99,17,1,0
3269,2022-03-05,Portland Trail Blazers,121,Minnesota Timberwolves,135,14,1,0
3270,2022-03-05,Golden State Warriors,116,Los Angeles Lakers,124,8,1,0
3271,2022-03-06,Brooklyn Nets,120,Boston Celtics,126,6,1,0
3272,2022-03-06,Phoenix Suns,122,Milwaukee Bucks,132,10,1,0
3273,2022-03-06,Indiana Pacers,123,Washington Wizards,133,10,1,0
3274,2022-03-06,Memphis Grizzlies,112,Houston Rockets,123,11,1,0
3275,2022-03-06,Utah Jazz,116,Oklahoma City Thunder,103,-13,0,1
3276,2022-03-06,Toronto Raptors,96,Cleveland Cavaliers,104,8,1,0
3277,2022-03-06,New Orleans Pelicans,130,Denver Nuggets,138,8,1,0
3278,2022-03-06,New York Knicks,116,Los Angeles Clippers,93,-23,0,1
3279,2022-03-07,Atlanta Hawks,110,Detroit Pistons,113,3,1,0
3280,2022-03-07,Chicago Bulls,106,Philadelphia 76ers,121,15,1,0
3281,2022-03-07,Houston Rockets,106,Miami Heat,123,17,1,0
3282,2022-03-07,Portland Trail Blazers,81,Minnesota Timberwolves,124,43,1,0
3283,2022-03-07,Utah Jazz,103,Dallas Mavericks,111,8,1,0
3284,2022-03-07,Los Angeles Lakers,110,San Antonio Spurs,117,7,1,0
3285,2022-03-07,Golden State Warriors,124,Denver Nuggets,131,7,1,0
3286,2022-03-07,New York Knicks,131,Sacramento Kings,115,-16,0,1
3287,2022-03-08,Brooklyn Nets,132,Charlotte Hornets,121,-11,0,1
3288,2022-03-08,Cleveland Cavaliers,127,Indiana Pacers,124,-3,0,1
3289,2022-03-08,Phoenix Suns,102,Orlando Magic,99,-3,0,1
3290,2022-03-08,New Orleans Pelicans,111,Memphis Grizzlies,132,21,1,0
3291,2022-03-08,Milwaukee Bucks,142,Oklahoma City Thunder,115,-27,0,1
3292,2022-03-08,Los Angeles Clippers,97,Golden State Warriors,112,15,1,0
3293,2022-03-09,Boston Celtics,115,Charlotte Hornets,101,-14,0,1
3294,2022-03-09,Chicago Bulls,114,Detroit Pistons,108,-6,0,1
3295,2022-03-09,Phoenix Suns,111,Miami Heat,90,-21,0,1
3296,2022-03-09,Los Angeles Lakers,130,Houston Rockets,139,9,1,0
3297,2022-03-09,Atlanta Hawks,115,Milwaukee Bucks,124,9,1,0
3298,2022-03-09,Oklahoma City Thunder,102,Minnesota Timberwolves,132,30,1,0
3299,2022-03-09,Orlando Magic,108,New Orleans Pelicans,102,-6,0,1
3300,2022-03-09,New York Knicks,107,Dallas Mavericks,77,-30,0,1
3301,2022-03-09,Toronto Raptors,119,San Antonio Spurs,104,-15,0,1
3302,2022-03-09,Denver Nuggets,106,Sacramento Kings,100,-6,0,1
3303,2022-03-09,Portland Trail Blazers,85,Utah Jazz,123,38,1,0
3304,2022-03-09,Washington Wizards,109,Los Angeles Clippers,115,6,1,0
3305,2022-03-10,Brooklyn Nets,129,Philadelphia 76ers,100,-29,0,1
3306,2022-03-10,Golden State Warriors,113,Denver Nuggets,102,-11,0,1
3307,2022-03-11,Minnesota Timberwolves,110,Orlando Magic,118,8,1,0
3308,2022-03-11,Los Angeles Clippers,106,Atlanta Hawks,112,6,1,0
3309,2022-03-11,Detroit Pistons,103,Boston Celtics,114,11,1,0
3310,2022-03-11,Dallas Mavericks,113,Houston Rockets,100,-13,0,1
3311,2022-03-11,New York Knicks,114,Memphis Grizzlies,118,4,1,0
3312,2022-03-11,Cleveland Cavaliers,105,Miami Heat,117,12,1,0
3313,2022-03-11,Charlotte Hornets,142,New Orleans Pelicans,120,-22,0,1
3314,2022-03-11,Utah Jazz,102,San Antonio Spurs,104,2,1,0
3315,2022-03-11,Toronto Raptors,117,Phoenix Suns,112,-5,0,1
3316,2022-03-11,Washington Wizards,109,Los Angeles Lakers,122,13,1,0
3317,2022-03-12,Cleveland Cavaliers,91,Chicago Bulls,101,10,1,0
3318,2022-03-12,Minnesota Timberwolves,113,Miami Heat,104,-9,0,1
3319,2022-03-12,Indiana Pacers,119,San Antonio Spurs,108,-11,0,1
3320,2022-03-12,Milwaukee Bucks,109,Golden State Warriors,122,13,1,0
3321,2022-03-12,Toronto Raptors,127,Denver Nuggets,115,-12,0,1
3322,2022-03-12,Sacramento Kings,125,Utah Jazz,134,9,1,0
3323,2022-03-12,Washington Wizards,118,Portland Trail Blazers,127,9,1,0
3324,2022-03-13,New York Knicks,107,Brooklyn Nets,110,3,1,0
3325,2022-03-13,Los Angeles Clippers,106,Detroit Pistons,102,-4,0,1
3326,2022-03-13,Dallas Mavericks,95,Boston Celtics,92,-3,0,1
3327,2022-03-13,Philadelphia 76ers,116,Orlando Magic,114,-2,0,1
3328,2022-03-13,Indiana Pacers,128,Atlanta Hawks,131,3,1,0
3329,2022-03-13,Houston Rockets,105,New Orleans Pelicans,130,25,1,0
3330,2022-03-13,Memphis Grizzlies,125,Oklahoma City Thunder,118,-7,0,1
3331,2022-03-13,Los Angeles Lakers,111,Phoenix Suns,140,29,1,0
3332,2022-03-14,Los Angeles Clippers,111,Cleveland Cavaliers,120,9,1,0
3333,2022-03-14,Portland Trail Blazers,113,Atlanta Hawks,122,9,1,0
3334,2022-03-14,Denver Nuggets,114,Philadelphia 76ers,110,-4,0,1
3335,2022-03-14,Charlotte Hornets,134,Oklahoma City Thunder,116,-18,0,1
3336,2022-03-14,Minnesota Timberwolves,149,San Antonio Spurs,139,-10,0,1
3337,2022-03-14,Washington Wizards,112,Golden State Warriors,126,14,1,0
3338,2022-03-14,Chicago Bulls,103,Sacramento Kings,112,9,1,0
3339,2022-03-14,Milwaukee Bucks,117,Utah Jazz,111,-6,0,1
3340,2022-03-14,Toronto Raptors,114,Los Angeles Lakers,103,-11,0,1
3341,2022-03-15,Memphis Grizzlies,135,Indiana Pacers,102,-33,0,1
3342,2022-03-15,Brooklyn Nets,150,Orlando Magic,108,-42,0,1
3343,2022-03-15,Detroit Pistons,98,Miami Heat,105,7,1,0
3344,2022-03-15,Phoenix Suns,131,New Orleans Pelicans,115,-16,0,1
3345,2022-03-16,Atlanta Hawks,106,Charlotte Hornets,116,10,1,0
3346,2022-03-16,Philadelphia 76ers,118,Cleveland Cavaliers,114,-4,0,1
3347,2022-03-16,Denver Nuggets,127,Washington Wizards,109,-18,0,1
3348,2022-03-16,Dallas Mavericks,113,Brooklyn Nets,111,-2,0,1
3349,2022-03-16,Portland Trail Blazers,98,New York Knicks,128,30,1,0
3350,2022-03-16,Phoenix Suns,129,Houston Rockets,112,-17,0,1
3351,2022-03-16,Los Angeles Lakers,104,Minnesota Timberwolves,124,20,1,0
3352,2022-03-16,Oklahoma City Thunder,120,San Antonio Spurs,122,2,1,0
3353,2022-03-16,Chicago Bulls,110,Utah Jazz,125,15,1,0
3354,2022-03-16,Boston Celtics,110,Golden State Warriors,88,-22,0,1
3355,2022-03-16,Milwaukee Bucks,135,Sacramento Kings,126,-9,0,1
3356,2022-03-16,Toronto Raptors,103,Los Angeles Clippers,100,-3,0,1
3357,2022-03-17,Detroit Pistons,134,Orlando Magic,120,-14,0,1
3358,2022-03-18,Dallas Mavericks,101,Philadelphia 76ers,111,10,1,0
3359,2022-03-18,Memphis Grizzlies,105,Atlanta Hawks,120,15,1,0
3360,2022-03-18,Portland Trail Blazers,123,Brooklyn Nets,128,5,1,0
3361,2022-03-18,Denver Nuggets,116,Cleveland Cavaliers,119,3,1,0
3362,2022-03-18,Washington Wizards,97,New York Knicks,100,3,1,0
3363,2022-03-18,Los Angeles Lakers,128,Toronto Raptors,123,-5,0,1
3364,2022-03-18,Indiana Pacers,121,Houston Rockets,118,-3,0,1
3365,2022-03-18,Oklahoma City Thunder,108,Miami Heat,120,12,1,0
3366,2022-03-18,New Orleans Pelicans,124,San Antonio Spurs,91,-33,0,1
3367,2022-03-18,Los Angeles Clippers,92,Utah Jazz,121,29,1,0
3368,2022-03-18,Chicago Bulls,102,Phoenix Suns,129,27,1,0
3369,2022-03-18,Boston Celtics,126,Sacramento Kings,97,-29,0,1
3370,2022-03-19,Milwaukee Bucks,119,Minnesota Timberwolves,138,19,1,0
3371,2022-03-19,Dallas Mavericks,108,Charlotte Hornets,129,21,1,0
3372,2022-03-19,Detroit Pistons,109,Cleveland Cavaliers,113,4,1,0
3373,2022-03-19,Los Angeles Lakers,119,Washington Wizards,127,8,1,0
3374,2022-03-20,Memphis Grizzlies,122,Houston Rockets,98,-24,0,1
3375,2022-03-20,Portland Trail Blazers,98,Indiana Pacers,129,31,1,0
3376,2022-03-20,New Orleans Pelicans,117,Atlanta Hawks,112,-5,0,1
3377,2022-03-20,Oklahoma City Thunder,85,Orlando Magic,90,5,1,0
3378,2022-03-20,Phoenix Suns,127,Sacramento Kings,124,-3,0,1
3379,2022-03-20,Utah Jazz,108,New York Knicks,93,-15,0,1
3380,2022-03-20,Boston Celtics,124,Denver Nuggets,104,-20,0,1
3381,2022-03-20,San Antonio Spurs,110,Golden State Warriors,108,-2,0,1
3382,2022-03-20,Toronto Raptors,93,Philadelphia 76ers,88,-5,0,1
3383,2022-03-21,New Orleans Pelicans,103,Charlotte Hornets,106,3,1,0
3384,2022-03-21,Los Angeles Lakers,131,Cleveland Cavaliers,120,-11,0,1
3385,2022-03-21,Portland Trail Blazers,119,Detroit Pistons,115,-4,0,1
3386,2022-03-21,Utah Jazz,106,Brooklyn Nets,114,8,1,0
3387,2022-03-21,Miami Heat,106,Philadelphia 76ers,113,7,1,0
3388,2022-03-21,Toronto Raptors,99,Chicago Bulls,113,14,1,0
3389,2022-03-21,Washington Wizards,97,Houston Rockets,115,18,1,0
3390,2022-03-21,Boston Celtics,132,Oklahoma City Thunder,123,-9,0,1
3391,2022-03-21,Minnesota Timberwolves,108,Dallas Mavericks,110,2,1,0
3392,2022-03-22,Golden State Warriors,90,Orlando Magic,94,4,1,0
3393,2022-03-22,Atlanta Hawks,117,New York Knicks,111,-6,0,1
3394,2022-03-22,Chicago Bulls,98,Milwaukee Bucks,126,28,1,0
3395,2022-03-22,Los Angeles Clippers,115,Denver Nuggets,127,12,1,0
3396,2022-03-23,New York Knicks,121,Charlotte Hornets,106,-15,0,1
3397,2022-03-23,Atlanta Hawks,101,Detroit Pistons,122,21,1,0
3398,2022-03-23,Sacramento Kings,110,Indiana Pacers,109,-1,0,1
3399,2022-03-23,Utah Jazz,97,Boston Celtics,125,28,1,0
3400,2022-03-23,Brooklyn Nets,120,Memphis Grizzlies,132,12,1,0
3401,2022-03-23,Golden State Warriors,118,Miami Heat,104,-14,0,1
3402,2022-03-23,Phoenix Suns,125,Minnesota Timberwolves,116,-9,0,1
3403,2022-03-23,Orlando Magic,102,Oklahoma City Thunder,118,16,1,0
3404,2022-03-23,Houston Rockets,91,Dallas Mavericks,110,19,1,0
3405,2022-03-23,Philadelphia 76ers,126,Los Angeles Lakers,121,-5,0,1
3406,2022-03-23,San Antonio Spurs,133,Portland Trail Blazers,96,-37,0,1
3407,2022-03-24,Cleveland Cavaliers,104,Toronto Raptors,117,13,1,0
3408,2022-03-24,Indiana Pacers,103,Memphis Grizzlies,133,30,1,0
3409,2022-03-24,Washington Wizards,102,Milwaukee Bucks,114,12,1,0
3410,2022-03-24,Chicago Bulls,109,New Orleans Pelicans,126,17,1,0
3411,2022-03-24,Phoenix Suns,140,Denver Nuggets,130,-10,0,1
3412,2022-03-25,Utah Jazz,101,Charlotte Hornets,107,6,1,0
3413,2022-03-25,Washington Wizards,100,Detroit Pistons,97,-3,0,1
3414,2022-03-25,Golden State Warriors,110,Atlanta Hawks,121,11,1,0
3415,2022-03-25,New York Knicks,111,Miami Heat,103,-8,0,1
3416,2022-03-25,Dallas Mavericks,95,Minnesota Timberwolves,116,21,1,0
3417,2022-03-25,Houston Rockets,125,Portland Trail Blazers,106,-19,0,1
3418,2022-03-25,Philadelphia 76ers,122,Los Angeles Clippers,97,-25,0,1
3419,2022-03-26,San Antonio Spurs,107,New Orleans Pelicans,103,-4,0,1
3420,2022-03-26,Sacramento Kings,114,Orlando Magic,110,-4,0,1
3421,2022-03-26,Indiana Pacers,91,Toronto Raptors,131,40,1,0
3422,2022-03-26,Chicago Bulls,98,Cleveland Cavaliers,94,-4,0,1
3423,2022-03-26,Milwaukee Bucks,102,Memphis Grizzlies,127,25,1,0
3424,2022-03-26,Brooklyn Nets,110,Miami Heat,95,-15,0,1
3425,2022-03-26,Oklahoma City Thunder,107,Denver Nuggets,113,6,1,0
3426,2022-03-26,Houston Rockets,115,Portland Trail Blazers,98,-17,0,1
3427,2022-03-27,New York Knicks,104,Detroit Pistons,102,-2,0,1
3428,2022-03-27,Minnesota Timberwolves,112,Boston Celtics,134,22,1,0
3429,2022-03-27,Philadelphia 76ers,104,Phoenix Suns,114,10,1,0
3430,2022-03-27,Golden State Warriors,115,Washington Wizards,123,8,1,0
3431,2022-03-27,Los Angeles Lakers,108,New Orleans Pelicans,116,8,1,0
3432,2022-03-27,Charlotte Hornets,119,Brooklyn Nets,110,-9,0,1
3433,2022-03-27,Utah Jazz,100,Dallas Mavericks,114,14,1,0
3434,2022-03-28,Denver Nuggets,113,Charlotte Hornets,109,-4,0,1
3435,2022-03-28,Orlando Magic,101,Cleveland Cavaliers,107,6,1,0
3436,2022-03-28,Atlanta Hawks,132,Indiana Pacers,123,-9,0,1
3437,2022-03-28,Sacramento Kings,100,Miami Heat,123,23,1,0
3438,2022-03-28,Chicago Bulls,104,New York Knicks,109,5,1,0
3439,2022-03-28,Boston Celtics,112,Toronto Raptors,115,3,1,0
3440,2022-03-28,San Antonio Spurs,123,Houston Rockets,120,-3,0,1
3441,2022-03-28,Golden State Warriors,95,Memphis Grizzlies,123,28,1,0
3442,2022-03-28,Oklahoma City Thunder,134,Portland Trail Blazers,131,-3,0,1
3443,2022-03-29,Milwaukee Bucks,118,Philadelphia 76ers,116,-2,0,1
3444,2022-03-29,Chicago Bulls,107,Washington Wizards,94,-13,0,1
3445,2022-03-29,Detroit Pistons,123,Brooklyn Nets,130,7,1,0
3446,2022-03-29,Los Angeles Lakers,110,Dallas Mavericks,128,18,1,0
3447,2022-03-29,Utah Jazz,115,Los Angeles Clippers,121,6,1,0
3448,2022-03-30,Dallas Mavericks,120,Cleveland Cavaliers,112,-8,0,1
3449,2022-03-30,Denver Nuggets,125,Indiana Pacers,118,-7,0,1
3450,2022-03-30,Orlando Magic,110,Washington Wizards,127,17,1,0
3451,2022-03-30,Miami Heat,106,Boston Celtics,98,-8,0,1
3452,2022-03-30,Charlotte Hornets,125,New York Knicks,114,-11,0,1
3453,2022-03-30,Minnesota Timberwolves,102,Toronto Raptors,125,23,1,0
3454,2022-03-30,Sacramento Kings,121,Houston Rockets,118,-3,0,1
3455,2022-03-30,Atlanta Hawks,136,Oklahoma City Thunder,118,-18,0,1
3456,2022-03-30,Memphis Grizzlies,112,San Antonio Spurs,111,-1,0,1
3457,2022-03-30,Phoenix Suns,107,Golden State Warriors,103,-4,0,1
3458,2022-03-30,New Orleans Pelicans,117,Portland Trail Blazers,107,-10,0,1
3459,2022-03-31,Philadelphia 76ers,94,Detroit Pistons,102,8,1,0
3460,2022-03-31,Cleveland Cavaliers,107,Atlanta Hawks,131,24,1,0
3461,2022-03-31,Milwaukee Bucks,120,Brooklyn Nets,119,-1,0,1
3462,2022-03-31,Los Angeles Clippers,130,Chicago Bulls,135,5,1,0
3463,2022-03-31,Los Angeles Lakers,109,Utah Jazz,122,13,1,0
3464,2022-04-01,Toronto Raptors,102,Orlando Magic,89,-13,0,1
3465,2022-04-01,Dallas Mavericks,103,Washington Wizards,135,32,1,0
3466,2022-04-01,Indiana Pacers,123,Boston Celtics,128,5,1,0
3467,2022-04-01,Sacramento Kings,122,Houston Rockets,117,-5,0,1
3468,2022-04-01,Phoenix Suns,114,Memphis Grizzlies,122,8,1,0
3469,2022-04-01,Los Angeles Clippers,153,Milwaukee Bucks,119,-34,0,1
3470,2022-04-01,Detroit Pistons,110,Oklahoma City Thunder,101,-9,0,1
3471,2022-04-01,Portland Trail Blazers,111,San Antonio Spurs,130,19,1,0
3472,2022-04-01,Minnesota Timberwolves,136,Denver Nuggets,130,-6,0,1
3473,2022-04-01,New Orleans Pelicans,114,Los Angeles Lakers,111,-3,0,1
3474,2022-04-02,Charlotte Hornets,114,Philadelphia 76ers,144,30,1,0
3475,2022-04-02,Cleveland Cavaliers,119,New York Knicks,101,-18,0,1
3476,2022-04-02,Brooklyn Nets,115,Atlanta Hawks,122,7,1,0
3477,2022-04-02,Miami Heat,127,Chicago Bulls,109,-18,0,1
3478,2022-04-02,Utah Jazz,107,Golden State Warriors,111,4,1,0
3479,2022-04-03,Washington Wizards,102,Boston Celtics,144,42,1,0
3480,2022-04-03,Dallas Mavericks,118,Milwaukee Bucks,112,-6,0,1
3481,2022-04-03,Denver Nuggets,129,Los Angeles Lakers,118,-11,0,1
3482,2022-04-03,Detroit Pistons,121,Indiana Pacers,117,-4,0,1
3483,2022-04-03,Philadelphia 76ers,112,Cleveland Cavaliers,108,-4,0,1
3484,2022-04-03,New York Knicks,118,Orlando Magic,88,-30,0,1
3485,2022-04-03,Minnesota Timberwolves,139,Houston Rockets,132,-7,0,1
3486,2022-04-03,Phoenix Suns,96,Oklahoma City Thunder,117,21,1,0
3487,2022-04-03,Portland Trail Blazers,92,San Antonio Spurs,113,21,1,0
3488,2022-04-03,Miami Heat,114,Toronto Raptors,109,-5,0,1
3489,2022-04-03,Golden State Warriors,109,Sacramento Kings,90,-19,0,1
3490,2022-04-03,New Orleans Pelicans,100,Los Angeles Clippers,119,19,1,0
3491,2022-04-05,Philadelphia 76ers,131,Indiana Pacers,122,-9,0,1
3492,2022-04-05,Cleveland Cavaliers,115,Orlando Magic,120,5,1,0
3493,2022-04-05,Houston Rockets,105,Brooklyn Nets,118,13,1,0
3494,2022-04-05,Charlotte Hornets,115,Miami Heat,144,29,1,0
3495,2022-04-05,Atlanta Hawks,108,Toronto Raptors,118,10,1,0
3496,2022-04-05,Milwaukee Bucks,127,Chicago Bulls,106,-21,0,1
3497,2022-04-05,Washington Wizards,132,Minnesota Timberwolves,114,-18,0,1
3498,2022-04-05,Portland Trail Blazers,94,Oklahoma City Thunder,98,4,1,0
3499,2022-04-05,San Antonio Spurs,116,Denver Nuggets,97,-19,0,1
3500,2022-04-05,Memphis Grizzlies,115,Utah Jazz,121,6,1,0
3501,2022-04-05,New Orleans Pelicans,123,Sacramento Kings,109,-14,0,1
3502,2022-04-05,Los Angeles Lakers,110,Phoenix Suns,121,11,1,0
3503,2022-04-06,Dallas Mavericks,131,Detroit Pistons,113,-18,0,1
3504,2022-04-06,Brooklyn Nets,110,New York Knicks,98,-12,0,1
3505,2022-04-06,Washington Wizards,103,Atlanta Hawks,118,15,1,0
3506,2022-04-06,Boston Celtics,117,Chicago Bulls,94,-23,0,1
3507,2022-04-06,Oklahoma City Thunder,101,Utah Jazz,137,36,1,0
3508,2022-04-06,Phoenix Suns,109,Los Angeles Clippers,113,4,1,0
3509,2022-04-07,Orlando Magic,101,Charlotte Hornets,128,27,1,0
3510,2022-04-07,Boston Celtics,121,Milwaukee Bucks,127,6,1,0
3511,2022-04-07,Philadelphia 76ers,114,Toronto Raptors,119,5,1,0
3512,2022-04-07,San Antonio Spurs,121,Minnesota Timberwolves,127,6,1,0
3513,2022-04-07,Portland Trail Blazers,94,New Orleans Pelicans,127,33,1,0
3514,2022-04-07,Memphis Grizzlies,109,Denver Nuggets,122,13,1,0
3515,2022-04-07,Los Angeles Lakers,112,Golden State Warriors,128,16,1,0
3516,2022-04-08,Milwaukee Bucks,131,Detroit Pistons,101,-30,0,1
3517,2022-04-08,New York Knicks,114,Washington Wizards,92,-22,0,1
3518,2022-04-08,Cleveland Cavaliers,107,Brooklyn Nets,118,11,1,0
3519,2022-04-08,Houston Rockets,115,Toronto Raptors,117,2,1,0
3520,2022-04-08,Charlotte Hornets,133,Chicago Bulls,117,-16,0,1
3521,2022-04-08,Atlanta Hawks,109,Miami Heat,113,4,1,0
3522,2022-04-08,Portland Trail Blazers,78,Dallas Mavericks,128,50,1,0
3523,2022-04-08,Phoenix Suns,111,Utah Jazz,105,-6,0,1
3524,2022-04-08,Oklahoma City Thunder,101,Los Angeles Lakers,120,19,1,0
3525,2022-04-09,Indiana Pacers,120,Philadelphia 76ers,133,13,1,0
3526,2022-04-09,New Orleans Pelicans,114,Memphis Grizzlies,141,27,1,0
3527,2022-04-09,Golden State Warriors,100,San Antonio Spurs,94,-6,0,1
3528,2022-04-09,Sacramento Kings,98,Los Angeles Clippers,117,19,1,0
3529,2022-04-10,Indiana Pacers,126,Brooklyn Nets,134,8,1,0
3530,2022-04-10,Washington Wizards,108,Charlotte Hornets,124,16,1,0
3531,2022-04-10,Milwaukee Bucks,115,Cleveland Cavaliers,133,18,1,0
3532,2022-04-10,Atlanta Hawks,130,Houston Rockets,114,-16,0,1
3533,2022-04-10,Boston Celtics,139,Memphis Grizzlies,110,-29,0,1
3534,2022-04-10,Toronto Raptors,94,New York Knicks,105,11,1,0
3535,2022-04-10,Miami Heat,111,Orlando Magic,125,14,1,0
3536,2022-04-10,Detroit Pistons,106,Philadelphia 76ers,118,12,1,0
3537,2022-04-10,Chicago Bulls,124,Minnesota Timberwolves,120,-4,0,1
3538,2022-04-10,San Antonio Spurs,120,Dallas Mavericks,130,10,1,0
3539,2022-04-10,Los Angeles Lakers,146,Denver Nuggets,141,-5,0,1
3540,2022-04-10,Oklahoma City Thunder,88,Los Angeles Clippers,138,50,1,0
3541,2022-04-10,Golden State Warriors,128,New Orleans Pelicans,107,-21,0,1
3542,2022-04-10,Sacramento Kings,116,Phoenix Suns,109,-7,0,1
3543,2022-04-10,Utah Jazz,111,Portland Trail Blazers,80,-31,0,1
3544,2022-04-12,Cleveland Cavaliers,108,Brooklyn Nets,115,7,1,0
3545,2022-04-12,Los Angeles Clippers,104,Minnesota Timberwolves,109,5,1,0
3546,2022-04-13,Charlotte Hornets,103,Atlanta Hawks,132,29,1,0
3547,2022-04-13,San Antonio Spurs,103,New Orleans Pelicans,113,10,1,0
3548,2022-04-15,Atlanta Hawks,107,Cleveland Cavaliers,101,-6,0,1
3549,2022-04-15,New Orleans Pelicans,105,Los Angeles Clippers,101,-4,0,1
3550,2022-04-16,Utah Jazz,99,Dallas Mavericks,93,-6,0,1
3551,2022-04-16,Minnesota Timberwolves,130,Memphis Grizzlies,117,-13,0,1
3552,2022-04-16,Toronto Raptors,111,Philadelphia 76ers,131,20,1,0
3553,2022-04-16,Denver Nuggets,107,Golden State Warriors,123,16,1,0
3554,2022-04-17,Atlanta Hawks,91,Miami Heat,115,24,1,0
3555,2022-04-17,Brooklyn Nets,114,Boston Celtics,115,1,1,0
3556,2022-04-17,Chicago Bulls,86,Milwaukee Bucks,93,7,1,0
3557,2022-04-17,New Orleans Pelicans,99,Phoenix Suns,110,11,1,0
3558,2022-04-18,Toronto Raptors,97,Philadelphia 76ers,112,15,1,0
3559,2022-04-18,Utah Jazz,104,Dallas Mavericks,110,6,1,0
3560,2022-04-18,Denver Nuggets,106,Golden State Warriors,126,20,1,0
3561,2022-04-19,Atlanta Hawks,105,Miami Heat,115,10,1,0
3562,2022-04-19,Minnesota Timberwolves,96,Memphis Grizzlies,124,28,1,0
3563,2022-04-19,New Orleans Pelicans,125,Phoenix Suns,114,-11,0,1
3564,2022-04-20,Brooklyn Nets,107,Boston Celtics,114,7,1,0
3565,2022-04-20,Philadelphia 76ers,104,Toronto Raptors,101,-3,0,1
3566,2022-04-20,Chicago Bulls,114,Milwaukee Bucks,110,-4,0,1
3567,2022-04-21,Memphis Grizzlies,104,Minnesota Timberwolves,95,-9,0,1
3568,2022-04-21,Dallas Mavericks,126,Utah Jazz,118,-8,0,1
3569,2022-04-21,Golden State Warriors,118,Denver Nuggets,113,-5,0,1
3570,2022-04-22,Miami Heat,110,Atlanta Hawks,111,1,1,0
3571,2022-04-22,Milwaukee Bucks,111,Chicago Bulls,81,-30,0,1
3572,2022-04-22,Phoenix Suns,114,New Orleans Pelicans,111,-3,0,1
3573,2022-04-23,Philadelphia 76ers,102,Toronto Raptors,110,8,1,0
3574,2022-04-23,Dallas Mavericks,99,Utah Jazz,100,1,1,0
3575,2022-04-23,Boston Celtics,109,Brooklyn Nets,103,-6,0,1
3576,2022-04-23,Memphis Grizzlies,118,Minnesota Timberwolves,119,1,1,0
3577,2022-04-24,Milwaukee Bucks,119,Chicago Bulls,95,-24,0,1
3578,2022-04-24,Golden State Warriors,121,Denver Nuggets,126,5,1,0
3579,2022-04-24,Miami Heat,110,Atlanta Hawks,86,-24,0,1
3580,2022-04-24,Phoenix Suns,103,New Orleans Pelicans,118,15,1,0
3581,2022-04-25,Boston Celtics,116,Brooklyn Nets,112,-4,0,1
3582,2022-04-25,Toronto Raptors,103,Philadelphia 76ers,88,-15,0,1
3583,2022-04-25,Utah Jazz,77,Dallas Mavericks,102,25,1,0
3584,2022-04-26,Atlanta Hawks,94,Miami Heat,97,3,1,0
3585,2022-04-26,Minnesota Timberwolves,109,Memphis Grizzlies,111,2,1,0
3586,2022-04-26,New Orleans Pelicans,97,Phoenix Suns,112,15,1,0
3587,2022-04-27,Chicago Bulls,100,Milwaukee Bucks,116,16,1,0
3588,2022-04-27,Denver Nuggets,98,Golden State Warriors,102,4,1,0
3589,2022-04-28,Philadelphia 76ers,132,Toronto Raptors,97,-35,0,1
3590,2022-04-28,Phoenix Suns,115,New Orleans Pelicans,109,-6,0,1
3591,2022-04-28,Dallas Mavericks,98,Utah Jazz,96,-2,0,1
3592,2022-04-29,Memphis Grizzlies,114,Minnesota Timberwolves,106,-8,0,1
3593,2022-05-01,Milwaukee Bucks,101,Boston Celtics,89,-12,0,1
3594,2022-05-01,Golden State Warriors,117,Memphis Grizzlies,116,-1,0,1
3595,2022-05-02,Philadelphia 76ers,92,Miami Heat,106,14,1,0
3596,2022-05-02,Dallas Mavericks,114,Phoenix Suns,121,7,1,0
3597,2022-05-03,Milwaukee Bucks,86,Boston Celtics,109,23,1,0
3598,2022-05-03,Golden State Warriors,101,Memphis Grizzlies,106,5,1,0
3599,2022-05-04,Philadelphia 76ers,103,Miami Heat,119,16,1,0
3600,2022-05-04,Dallas Mavericks,109,Phoenix Suns,129,20,1,0
3601,2022-05-06,Miami Heat,79,Philadelphia 76ers,99,20,1,0
3602,2022-05-06,Phoenix Suns,94,Dallas Mavericks,103,9,1,0
3603,2022-05-07,Boston Celtics,101,Milwaukee Bucks,103,2,1,0
3604,2022-05-07,Memphis Grizzlies,112,Golden State Warriors,142,30,1,0
3605,2022-05-08,Phoenix Suns,101,Dallas Mavericks,111,10,1,0
3606,2022-05-08,Miami Heat,108,Philadelphia 76ers,116,8,1,0
3607,2022-05-09,Boston Celtics,116,Milwaukee Bucks,108,-8,0,1
3608,2022-05-09,Memphis Grizzlies,98,Golden State Warriors,101,3,1,0
3609,2022-05-10,Philadelphia 76ers,85,Miami Heat,120,35,1,0
3610,2022-05-10,Dallas Mavericks,80,Phoenix Suns,110,30,1,0
3611,2022-05-11,Milwaukee Bucks,110,Boston Celtics,107,-3,0,1
3612,2022-05-11,Golden State Warriors,95,Memphis Grizzlies,134,39,1,0
3613,2022-05-12,Miami Heat,99,Philadelphia 76ers,90,-9,0,1
3614,2022-05-12,Phoenix Suns,86,Dallas Mavericks,113,27,1,0
3615,2022-05-13,Boston Celtics,108,Milwaukee Bucks,95,-13,0,1
3616,2022-05-13,Memphis Grizzlies,96,Golden State Warriors,110,14,1,0
3617,2022-05-15,Milwaukee Bucks,81,Boston Celtics,109,28,1,0
3618,2022-05-15,Dallas Mavericks,123,Phoenix Suns,90,-33,0,1
3619,2022-05-17,Boston Celtics,107,Miami Heat,118,11,1,0
3620,2022-05-18,Dallas Mavericks,87,Golden State Warriors,112,25,1,0
3621,2022-05-19,Boston Celtics,127,Miami Heat,102,-25,0,1
3622,2022-05-20,Dallas Mavericks,117,Golden State Warriors,126,9,1,0
3623,2022-05-21,Miami Heat,109,Boston Celtics,103,-6,0,1
3624,2022-05-22,Golden State Warriors,109,Dallas Mavericks,100,-9,0,1
3625,2022-05-23,Miami Heat,82,Boston Celtics,102,20,1,0
3626,2022-05-24,Golden State Warriors,109,Dallas Mavericks,119,10,1,0
3627,2022-05-25,Boston Celtics,93,Miami Heat,80,-13,0,1
3628,2022-05-26,Dallas Mavericks,110,Golden State Warriors,120,10,1,0
3629,2022-05-27,Miami Heat,111,Boston Celtics,103,-8,0,1
3630,2022-05-29,Boston Celtics,100,Miami Heat,96,-4,0,1
3631,2022-06-02,Boston Celtics,120,Golden State Warriors,108,-12,0,1
3632,2022-06-05,Boston Celtics,88,Golden State Warriors,107,19,1,0
3633,2022-06-08,Golden State Warriors,100,Boston Celtics,116,16,1,0
3634,2022-06-10,Golden State Warriors,107,Boston Celtics,97,-10,0,1
3635,2022-06-13,Boston Celtics,94,Golden State Warriors,104,10,1,0
3636,2022-06-16,Golden State Warriors,103,Boston Celtics,90,-13,0,1
